Titre	Artiste	Quebec		Année	Style
Tant qu'on aura de l'amour	Les Cowboys Frigants	Oui			
Puits sans fond	Vulgaires Machins	Oui			
Hawaiienne	Les Trois Accords	Oui			
Calvaire	La Chicane	Oui			
Sous le Vent	Garou (ft Celine Dion)	Oui			
Libérez-Nous Des Libéraux	Loco Locass	Oui			
Rêver Mieux	Daniel Bélanger	Oui			
Bonhomme 7h	eXterio	Oui			
Bobépine	Plume Latraverse	Oui			
Jeter un sort	Laurence Jalbert	Oui			
Harmonium	Harmonium	Oui			
Caline de Blues	Offenbach	Oui			
Grand Champion	Les Trois Accords	Oui			
Gros Zéro	Yelo Molo	Oui			
Dans une Galaxie près de chez vous	Les Costauds	Oui			
Les Chats Sauvages	Marjo	Oui			
J'espère encore que quelque part l'attente s'arrête	Lou-Adriane Cassidy	Oui			
Si je rampe	Ariane Roy	Oui			
Le pyromane	Karkwa	Nouvelle			
Chance	Allô Fantome	Nouvelle			
Assis sur mon Tracteur	François Pérusse	Nouvelle			
20th Century Boy	T. Rex			1973	Glam
25 or 6 to 4	Chicago			1970	Classic Rock
Antibodies	Poni Hoax			2008	New Wave
Beast and the Harlot	Avenged Sevenfold			2005	Metal
The Beautiful People	Marilyn Manson			1996	Metal
Been Caught Stealing	Jane's Addiction			1990	Alternative
Before I Forget	Slipknot			2004	Nu-Metal
Bohemian Rhapsody	Queen			1975	Classic Rock
Break on Through (To the Other Side)	The Doors			1967	Classic Rock
Caught in a Mosh	Anthrax			1987	Metal
Centerfold	The J. Geils Band			1981	Rock
China Grove	The Doobie Brothers			1973	Classic Rock
Cold as Ice	Foreigner			1977	Classic Rock
Combat Baby	Metric			2003	Indie Rock
The Con	Tegan and Sara			2007	Indie Rock
Crazy Train	Ozzy Osbourne			1980	Metal
Crosstown Traffic	The Jimi Hendrix Experience			1968	Classic Rock
Dead End Friends	Them Crooked Vultures			2009	Rock
Don't Bury Me... I'm Still Not Dead	Riverboat Gamblers			2006	Punk
Don't Stand So Close to Me	The Police			1980	Rock
Du Hast	Rammstein			1997	Metal
Everybody Wants to Rule the World	Tears for Fears			1985	New Wave
False Alarm	The Bronx			2003	Punk
Fly Like an Eagle	Steve Miller Band			1976	Classic Rock
Foolin'	Def Leppard			1983	Rock
Free Bird	Lynyrd Skynyrd			1973	Southern Rock
Get Free	The Vines			2002	Rock
Get Up, Stand Up	Bob Marley and the Wailers			1973	Reggae/Ska
Good Vibrations (Live)[b]	The Beach Boys			1968	Classic Rock
The Hardest Button to Button	The White Stripes			2003	Rock
Heart of Glass	Blondie			1978	New Wave
Here I Go Again	Whitesnake			1987	Glam
Hey Man, Nice Shot	Filter			1995	Alternative
Humanoid	Tokio Hotel			2009	Pop-Rock
I Can See for Miles	The Who			1967	Classic Rock
I Got You (I Feel Good) (Alternative Version)[c]	James Brown			1974	R&B/Soul/Funk
I Love Rock N' Roll	Joan Jett & The Blackhearts			1981	Punk
I Need to Know	Tom Petty and the Heartbreakers			1978	Rock
I Wanna Be Sedated	Ramones			1978	Punk
Imagine	John Lennon			1971	Classic Rock
In a Big Country	Big Country			1983	New Wave
In the Meantime	Spacehog			1995	Alternative
Jerry Was a Race Car Driver	Primus			1991	Alternative
Just Like Heaven	The Cure			1987	New Wave
Killing Loneliness	HIM			2005	Alternative
The Killing Moon	Echo & The Bunnymen			1984	New Wave
King George	Dover			2001	Rock
Lasso	Phoenix			2009	Alternative
Last Dance	The Raveonettes			2009	Indie Rock
Living in America	The Sounds			2002	New Wave
Llama	Phish			1992	Rock
The Look	Roxette			1988	Pop-Rock
Low Rider	WAR			1975	R&B/Soul/Funk
Me Enamora	Juanes			2007	Pop-Rock
Midlife Crisis	Faith No More			1992	Rock
Misery Business	Paramore			2007	Pop-Rock
Need You Tonight	INXS			1987	Pop-Rock
No One Knows	Queens of the Stone Age			2002	Alternative
Oh My God	Ida Maria			2008	Alternative
One Armed Scissor	At the Drive-In			2000	Rock
Outer Space[e]	The Muffs			1997	Pop-Rock
Oye Mi Amor	Maná			1992	Pop-Rock
Plush	Stone Temple Pilots			1992	Alternative
Portions for Foxes	Rilo Kiley			2004	Indie Rock
The Power of Love	Huey Lewis and the News			1985	Rock
Radar Love	Golden Earring			1973	Classic Rock
Rainbow in the Dark	Dio			1983	Metal
Rehab	Amy Winehouse			2006	R&B/Soul/Funk
Rock Lobster	The B-52's			1979	New Wave
Roundabout	Yes			1971	Prog
Saturday Night's Alright for Fighting	Elton John			1973	Classic Rock
Sister Christian	Night Ranger			1983	Rock
Smoke on the Water	Deep Purple			1972	Classic Rock
Something Bigger, Something Brighter	Pretty Girls Make Graves			2003	Indie Rock
Space Oddity	David Bowie			1969	Glam
Stop Me If You Think You've Heard This One Before	The Smiths			1987	Indie Rock
This Bastard's Life	Swingin' Utters			1998	Punk
Viva la Resistance	Hypernova			2010	Indie Rock
Walk of Life	Dire Straits			1985	Rock
Walking on the Sun	Smash Mouth			1997	Pop-Rock
Werewolves of London	Warren Zevon			1978	Classic Rock
Whip It[e]	Devo			1980	New Wave
Yoshimi Battles the Pink Robots Pt. 1	The Flaming Lips			2002	Alternative
Light My Fire	The Doors				
Riders on the Storm	The Doors				
Touch Me	The Doors				
Hello, I Love You	The Doors				
L.A. Woman	The Doors				
Love Her Madly	The Doors				
Love Me Two Times	The Doors				
Peace Frog	The Doors				
People Are Strange	The Doors				
Roadhouse Blues	The Doors				
Soul Kitchen	The Doors				
The Crystal Ship	The Doors				
Subdivisions	Rush				
Bad Medicine	Bon Jovi				
Blaze of Glory	Bon Jovi				
Have a Nice Day	Bon Jovi				
I'll Be There for You	Bon Jovi				
It's My Life	Bon Jovi				
Lay Your Hands on Me	Bon Jovi				
Livin' on a Prayer (RB3 Version)	Bon Jovi				
Runaway	Bon Jovi				
Wanted Dead or Alive (RB3 Version)	Bon Jovi				
We Weren't Born To Follow	Bon Jovi				
Who Says You Can't Go Hone	Bon Jovi				
You Give Love a Bad Name (RB3 Version)	Bon Jovi				
Blue Monday	New Order				
Burning Down the House	Talking Heads				
My Own Summer	Deftones				
Jive Talkin'	Bee Gees				
Night Fever	Bee Gees				
Stayin' Alive	Bee Gees				
Nights on Broadway	Bee Gees				
Tragedy	Bee Gees				
You Should Be Dancing	Bee Gees				
The Thrill Is Gone	B.B. King				
A Whiter Shade of Pale	Procol Harum				
Crippled Inside	John Lennon				
Jealous Guy	John Lennon				
It's So Hard	John Lennon				
I Don't Want to Be a Soldier, Mama	John Lennon				
Gimme Some Truth	John Lennon				
Oh My Love	John Lennon				
How Do You Sleep?	John Lennon				
How?	John Lennon				
Oh, Yoko	John Lennon				
Hold on Loosely	.38 Special				
Can't Get Enough	Bad Company				
Saturday Night Special	Lynyrd Skynyrd				
Sweet Home Alabama (Live)	Lynyrd Skynyrd				
Tuesday's Gone	Lynyrd Skynyrd				
What's Your Name?	Lynyrd Skynyrd				
Hammer to Fall	Queen				
Keep Yourself Alive	Queen				
Now I'm Here	Queen				
Play the Game	Queen				
Tenement Funster	Queen				
We Are the Champions (RB3 Version)	Queen				
We Will Rock You (RB3 Version)	Queen				
I Want It All (RB3 Version)	Queen				
I Want to Break Free (RB3 Version)	Queen				
Killer Queen (RB3 Version)	Queen				
One Vision (RB3 Version)	Queen				
Somebody To Love (RB3 Version)	Queen				
Under Pressure	Queen and David Bowie				
Big Shot	Billy Joel				
Captain Jack	Billy Joel				
It's Still Rock and Roll to Me	Billy Joel				
Movin' Out (Anthony's Song)	Billy Joel				
Only the Good Die Young	Billy Joel				
Piano Man	Billy Joel				
Pressure	Billy Joel				
Say Goodbye to Hollywood	Billy Joel				
The Entertainer	Billy Joel				
The Stranger	Billy Joel				
We Didn't Start the Fire	Billy Joel				
You May Be Right	Billy Joel				
Happy Xmas (War Is Over)	John & Yoko/The Plastic Ono Band				
Peut-Être Une Angine	Anaïs Crozer				
Dis-Moi	BB Brunes				
Verdamp Lang Her	BAP				
Nur Ein Wort	Wir Sind Helden				
Fantasma	Linea 77				
Proibito	Litfiba				
Starting to Appreciate	Tutankamon				
Dame Aire	Skizoo				
Jerk It Out	Caesars				
Maybe I'm Amazed	Paul McCartney				
Band on the Run	Paul McCartney & Wings				
Helen Wheels	Paul McCartney & Wings				
Let Me Roll It	Paul McCartney & Wings				
Open My Eyes	Inhabited				
Cities In Dust	Siouxsie and The Banshees				
Cry, Cry, Cry	Johnny Cash				
Don't Take Your Guns to Town	Johnny Cash				
Five Feet High and Rising	Johnny Cash				
Folsom Prison Blues	Johnny Cash				
I Got Stripes	Johnny Cash				
I Walk the Line	Johnny Cash				
Tennessee Flat Top Box	Johnny Cash				
The Ballad of Ira Hayes	Johnny Cash				
Visions	Abnormality				
Get Clean	Anarchy Club				
Night Lies	Bang Camaro				
Shoulder to the Plow	Breaking Wheel				
Welcome to the Neighborhood	Lybians				
A Jagged Gorgeous Winter	The Main Drag				
Conventional Lover	Speck				
Supreme Girl	The Sterns				
Rob the Prez-O-Dent	That Handsome Devil				
Crawling	Linkin Park				
In the End	Linkin Park				
Numb	Linkin Park				
Somewhere I Belong	Linkin Park				
Waiting for the End	Linkin Park				
What I've Done	Linkin Park				
Made of Scares	Stone Sour				
Say You'll Haunt Me	Stone Sour				
Through Glass	Stone Sour				
Blue Jean	David Bowie				
Fame	David Bowie				
Modern Love	David Bowie				
Young Americans	David Bowie				
Ziggy Stardust	David Bowie				
London Calling	The Clash				
Brand New Cadillac	The Clash				
Jimmy Jazz	The Clash				
Hateful	The Clash				
Rudie Can't Fail	The Clash				
Spanish Bombs	The Clash				
The Right Profile	The Clash				
Lost in the Supermarket	The Clash				
Clampdown	The Clash				
The Guns of Brixton	The Clash				
Wrong 'Em Boyo	The Clash				
Death or Glory	The Clash				
Koka Kola	The Clash				
The Card Cheat	The Clash				
Lover's Rock	The Clash				
Four Horsemen	The Clash				
I'm Not Down	The Clash				
Revolution Rock	The Clash				
Bend Down Low	Bob Marley and The Wailers				
Burnin' and Lootin'	Bob Marley and The Wailers				
Coming in From The Cold	Bob Marley and The Wailers				
Kaya	Bob Marley and The Wailers				
Lively Up Yourself	Bob Marley and The Wailers				
No More Trouble	Bob Marley and The Wailers				
Small Axe	Bob Marley and The Wailers				
Them Belly Full (But We Hungry)	Bob Marley and The Wailers				
Obsession	Animotion				
Airplanes	B.o.B feat. Hayley Williams				
Total Eclipse of the Heart	Bonnie Tyler				
Don't You Want Me	The Human League				
Need You Now	Lady Antebellum				
Paradise by the Dashboard Light	Meat Loaf				
Stop Draggin' My Heart Around	Stevie Nicks & Tom Petty and The Heartbreakers				
Fire and Ice	Pat Benatar				
Love Is a Battlefield	Pat Benatar				
Shadows of the Night	Pat Benatar				
We Belong	Pat Benatar				
Invincible	Pat Benatar				
Promises in the Dark	Pat Benatar				
Terrible Lie	Nine Inch Nails				
Head Like a Hole	Nine Inch Nails				
Sanctified	Nine Inch Nails				
The Only Time	Nine Inch Nails				
Never Let Me Down Again	Depeche Mode				
Personal Jesus	Depeche Mode				
Policy of Truth	Depeche Mode				
I Will Possess Your Heart	Death Cab for Cutie				
Shooting the Moon	OK Go				
Every Breath You Take	The Police				
So Lonely	The Police				
Spill the Wine	War				
I Go to Extremes	Billy Joel				
Miami 2017 (Seen the Lights Go Out on Broadway)	Billy Joel				
My Life	Billy Joel				
Prelude/Angry Young Man	Billy Joel				
Scenes from an Italian Restaurant	Billy Joel				
She's Always a Woman	Billy Joel				
Somebody to Love	Jefferson Airplane				
Spinning Wheel	Blood, Sweet & Tears				
Black Magic Woman	Carlos Santana				
Through the Fire and Flames	DragonForce				
Operation Ground and Pound	DragonForce				
The Loco-Motion	Grand Funk Railroad (original by Little Eva)				
We're an American Band	Grand Funk Railroad				
Freeze-Frame	The J. Geils Band				
Love Will Tear Us Apart	Joy Division				
Dreams	Fleetwood Mac				
Gold Dust Woman	Fleetwood Mac				
Landslide	Fleetwood Mac				
Rhiannon	Fleetwood Mac				
Edge of Seventeen	Stevie Nicks				
Stand Back	Stevie Nicks				
Breaking	Anberlin				
Blood and Thunder	Mastodon				
Fire	Ohio Players				
Love Rollercoaster	Ohio Players				
Must Have Done Something Right	Relient K				
867-5309/Jenny	Tommy Tutone				
Blue Bayou	Roy Orbison				
Dream Baby (How Long Must I Dream)	Roy Orbison				
Only the Lonely (Know the Way I Feel)	Roy Orbison				
Rock and Roll All Nite (Live)	KISS				
Strutter (Live)	KISS				
Do You Really Want to Hurt Me	Culture Club				
From Out of Nowhere	Faith No More				
Working for the Weekend	Loverboy				
Stash	Phish				
Tweezer	Phish				
Big Bang Baby	Stone Temple Pilots				
Long Road to Ruin	Foo Fighters				
Rope	Foo Fighters				
Stacked Actors	Foo Fighters				
Walk	Foo Fighters				
Hard Rock Hallelujah	Lordi				
King of Rock	Run-DMC				
Five Minutes Alone	Pantera				
Walk	Pantera				
Mouth for War	Pantera				
I'm Broken	Pantera				
Do You Feel Like We Do (Live)	Peter Frampton				
Born This Way	Lady Gaga				
Lovegame	Lady Gaga				
Paparazzi	Lady Gaga				
Hot Blooded	Foreigner				
Urgent	Foreigner				
Mr. Crowley	Ozzy Osbourne				
Over the Mountain	Ozzy Osbourne				
Bark at the Moon	Ozzy Osbourne				
Mama, I'm Coming Home	Ozzy Osbourne				
Steal Away (The Night)	Ozzy Osbourne				
Flying High Again	Ozzy Osbourne				
Diary of a Madman	Ozzy Osbourne				
I Don't Know	Ozzy Osbourne				
Grenade	Bruno Mars				
Just the Way You Are	Bruno Mars				
Marry You	Bruno Mars				
Audience of One	Rise Against				
Help Is on the Way	Rise Against				
The Good Left Undone	Rise Against				
Take on Me	A-ha				
Unholy Confessions	Avenged Sevenfold				
Welcome to the Family	Avenged Sevenfold				
Tubthumping	Chumbawamba				
I Alone	Live				
Lightning Crashes	Live				
Misery	Maroon 5				
This Love	Maroon 5				
Won't Go Home Without You	Maroon 5				
Blurry	Puddle of Mudd				
Control	Puddle of Mudd				
She Hates Me	Puddle of Mudd				
Here Without You	3 Doors Down				
When I'm Gone	3 Doors Down				
When You're Young	3 Doors Down				
Nothin' But a Good Time	Poison				
Talk Dirty to Me	Poison				
Unskinny Bop	Poison				
For What It's Worth	Buffalo Springfield				
Man on the Moon	R.E.M.				
Aerials	System of a Down				
Hypnotize	System of a Down				
Turning Japanese	The Vapors				
A Little Respect	Erasure				
Relax	Frankie Goes To Hollywood				
Boom	P.O.D.				
Young of the Nation	P.O.D.				
Blow Up the Outside World	Soundgarden				
Burden in My Hand	Soundgarden				
Fell on Black Days	Soundgarden				
Outshined	Soundgarden				
Rusty Cage	Soundgarden				
The Day I Tried to Live	Soundgarden				
Heart of the Sunrise	Yes				
I've Seen All Good People	Yes				
Owner of a Lonely Heart	Yes				
South Side of the Sky	Yes				
Starship Trooper	Yes				
Make Some Noise	Beastie Boys				
No Sleep Till Brooklyn	Beastie Boys				
Barracuda	Heart				
Super Bad, Pts. 1 & 2	James Brown				
Tell Me Something Good	Rufus feat. Chaka Khan				
Animal (Live)	Def Leppard				
Bringin' On the Heartbreak	Def Leppard				
Photograph	Def Leppard				
Pour Some Sugar on Me (Live)	Def Leppard				
Rock of Ages	Def Leppard				
Undefeated	Def Leppard				
Dance, Dance	Fall Out Boy				
Sugar, We're Goin Down	Fall Out Boy				
Thnks fr th Mmrs	Fall Out Boy				
Child in Time	Deep Purple				
Adolescents	Incubus				
Pardon Me	Incubus				
Wish You Were Here	Incubus				
By the Way	Red Hot Chili Peppers				
Californication	Red Hot Chili Peppers				
Look Around	Red Hot Chili Peppers				
Monarchy of Roses	Red Hot Chili Peppers				
Otherside	Red Hot Chili Peppers				
Parallel Universe	Red Hot Chili Peppers				
Scar Tissue	Red Hot Chili Peppers				
The Adventures of Rain Dance Maggie	Red Hot Chili Peppers				
I Want You to Want Me (Live)	Cheap Trick				
Surrender (Live)	Cheap Trick				
Dream Police	Cheap Trick				
Unbelievable	EMF				
Me and Bobby McGee	Janis Joplin and the Full Tilt Boogie Band				
Hash Pipe	Weezer				
Island in the Sun	Weezer				
Perfect Situation	Weezer				
Heart-Shaped Box	Nirvana				
Rape Me	Nirvana				
All Apologies	Nirvana				
You Know You're Right	Nirvana				
Wait and Bleed	Slipknot				
Left Behind	Slipknot				
Pulse of the Maggots	Slipknot				
Snuff	Slipknot				
Gold Cobra	Limp Bizkit				
Nookie	Limp Bizkit				
My Way	Limp Bizkit				
Re-Arranged	Limp Bizkit				
Rock the Casbah	The Clash				
The Party Song	Blink-182				
Stay Together for the Kids	Blink-182				
Up All Night	Blink-182				
Yellow	Coldplay				
The Scientist	Coldplay				
Clocks	Coldplay				
Fix You	Coldplay				
Viva La Vida	Coldplay				
Every Teardrop Is a Waterfall	Coldplay				
I Believe in a Thing Called Love	The Darkness				
Living Dead Girl	Rob Zombie				
Thunder Kiss '65	White Zombie				
Super-Charger Heaven	White Zombie				
Sooner or Later	Breaking Benjamin				
Breath	Breaking Benjamin				
Until the End	Breaking Benjamin				
Forever	Papa Roach				
Single White Female (RB3 version)	Chely Wright				
Giddy on Up (RB3 version)	Laura Bell Bundy				
The Night The Lights Went Out in Georgia (RB3 version)	Reba McEntire				
Party For Two (RB3 version)	Shania Twain feat. Billy Currington				
Settlin' (RB3 version)	Sugarland				
That's How Country Boys Roll (RB3 version)	Billy Currington				
Awful Beautiful Life (RB3 version)	Darryl Worley				
Man of Me (RB3 version)	Gary Allan				
Twang (RB3 version)	George Strait				
Ring of Fire (RB3 version)	Johnny Cash				
Backwoods (RB3 version)	Justin Moore				
Alright (RB3 version)	Darius Rucker				
Sideways (RB3 version)	Dierks Bentley				
Kiss a Girl (RB3 version)	Keith Urban				
Perfect Day (RB3 version)	Lady Antebellum				
Rain Is a Good Thing (RB3 version)	Luke Bryan				
Mama Tried (RB3 version)	Merle Haggard				
Ride (RB3 version)	Trace Adkins				
Intentional Heartache (RB3 version)	Dwight Yoakam				
Crazy Town (RB3 version)	Jason Aldean				
Summer Nights (RB3 version)	Rascal Flatts				
Superstition	Stevie Wonder				
Higher Ground	Stevie Wonder				
Living for the City	Stevie Wonder				
Sir Duke	Stevie Wonder				
I wish	Stevie Wonder				
How You Remind Me	Nickelback				
Someday	Nickelback				
Animals	Nickelback				
If Today Was Your Last Day	Nickelback				
This Means War	Nickelback				
On the Backs of Angels	Dream Theater				
Ghost of Perdition	Opeth				
In Waves	Trivium				
We Built This City	Starship				
Seven Seas of Rhye	Queen				
Stone Cold Crazy	Queen				
I'm in Love With My Car	Queen				
You're My Best Friend	Queen				
Long Away	Queen				
Bicycle Race	Queen				
Don't Stop Me Now	Queen				
Radio Ga Ga	Queen				
The Show Must Go On	Queen				
Fly by Night	Rush				
Caravan	Rush				
The Spirit of Radio (Live)	Rush				
Rebel Love Song	Black Veil Brides				
A Warrior's Call	Volbeat				
Long Hot Summer Night	The Jimi Hendrix Experience				
Gypsy Eyes	The Jimi Hendrix Experience				
All Along The Watchtower	The Jimi Hendrix Experience (original by Bob Dylan)				
Voodoo Child (Slight Return) (Live)	Jimi Hendrix				
Dolly Dagger	Jimi Hendrix				
Freedom	Jimi Hendrix				
Angel	Jimi Hendrix				
You Make Me Feel...	Cobra Starship feat. Sabi				
Stereo Hearts	Gym Class Heroes feat. Adam Levine				
I Write Sins Not Tragedies	Panic! At The Disco				
Pressure	Paramore				
Panic	Sublime With Rome				
Billionaire	Travie McCoy feat. Bruno Mars				
2112	Rush				
2112: Overture, The Temple of Syrinx	Rush				
2112: Discovery, Presentation	Rush				
2112: Oracle: The Dream, Soliloquy, Grand Finale	Rush				
Private Eyes	Hall & Oates				
I Can't Go For That (No Can Do)	Hall & Oates				
Maneater	Hall & Oates				
Free Ride	Edgar Winter Group				
Frankenstein	Edgar Winter Group				
Freak on a Leash	Korn				
Falling Away From Me	Korn				
Lodi	Creedence Clearwater Revival				
Have You Ever Seen The Rain	Creedence Clearwater Revival				
Suzie Q	Creedence Clearwater Revival				
Fat Lip	Sum 41				
Still Waiting	Sum 41				
Head Over Heels	Tears for Fears				
Everything Zen	Bush				
Comedown	Bush				
Machinehead	Bush				
Alone	Heart				
To Be With You	Mr. Big				
Never Gonna Give You Up	Rick Astley				
Symphony of Destruction	Megadeth				
À Tout Le Monde	Megadeth				
Public Enemy No. 1	Megadeth				
Do You Believe in Love	Huey Lewis and The News				
The Heart of Rock & Roll	Huey Lewis and The News				
I Want a New Drug	Huey Lewis and The News				
Santa Monica	Everclear				
The Anthem	Good Charlotte				
Curl of the Burl	Mastodon				
The Good Life	Three Days Grace				
I Hate Everything About You	Three Days Grace				
Pain	Three Days Grace				
Down Under	Men At Work				
Overkill	Men At Work				
Smooth	Carlos Santana feat. Rob Thomas				
Second Chance	Shinedown				
The Crow and the Butterfly	Shinedown				
Bully	Shinedown				
Everybody's Fool	Evanescence				
Lithium	Evanescence				
What You Want	Evanescence				
Raining Blood	Slayer				
South of Heaven	Slayer				
Seasons in the Abyss	Slayer				
Get the Party Started	P!nk				
Funhouse	P!nk				
Please Don't Leave Me	P!nk				
Sober	P!nk				
Nobody's Fool	Cinderella				
Don't Know What You Gone (Till It's Gone)	Cinderella				
Shelter Me	Cinderella				
Two Tickets to Paradise	Eddie Money				
Only One	Yellowcard				
Drops of Jupiter	Train				
Bombtrack	Rage Against the Machine				
Killing in the Name	Rage Against the Machine				
Sleep Now in the Fire	Rage Against the Machine				
Ignorance	Paramore				
Brick by Boring Brick	Paramore				
The Only Exception	Paramore				
Phantom of the Opera	Iron Maiden				
The Prisioner	Iron Maiden				
Flight of Icuarus	Iron Maiden				
Rime of the Ancient Mariner	Iron Maiden				
Infinite Dreams	Iron Maiden				
Seventh Son of a Seventh Son	Iron Maiden				
Tears Don't Fall	Bullet For My Valentine				
Scream Aim Fire	Bullet For My Valentine				
Your Betrayal	Bullet For My Valentine				
Teen Angst (What the World Needs Now)	Cracker				
Dog Days Are Over	Florence + The Machine				
Power and the Passion	Midnight Oil				
Drive	Incubus				
The Adventure	Angels & Airwaves				
Fireflies	Owl City				
In My Head	Queens of the Stone Age				
Before He Cheats	Carrie Underwood				
Cowboy Casanova	Carrie Underwood				
Good Girl	Carrie Underwood				
Gonzo	The All-American Rejects				
Happy?	Mudvayne				
Satellite	Rise Against				
It's Not Over	Daughtry				
No Surprise	Daughtry				
Crawling Back To You	Daughtry				
Love Shack	The B-52's				
Not Again	Staind				
My Body	Young The Giant				
Helena Beat	Foster The People				
Don't Stop (Color on the Walls)	Foster The People				
Under Cover of Darkness	The Strokes				
The End of Heartache	Killswitch Engage				
The Arms of Sorrow	Killswitch Engage				
Starting Over	Killswitch Engage				
(I Just) Died in Your Arms	Cutting Crew				
Still of the Night	Whitesnake				
Crawling in the Dark	Hoobastank				
I Want to Know What Love Is	Foreigner				
Waiting For a Girl Like You	Foreigner				
Amaranth	Nightwish				
Tighten Up	The Black Keys				
Howlin' For You	The Black Keys				
Lonely Boy	The Black Keys				
One Week	Barenaked Ladies				
These Days	Foo Fighters				
Death on Two Legs (Dedicated to...)	Queen				
Breaking the Habit	Linkin Park				
Shadow of the Day	Linkin Park				
New Divide	Linkin Park				
Burn It Down	Linkin Park				
Bent	Matchbox Twenty				
How Far We've Come	Matchbox Twenty				
She's So Mean	Matchbox Twenty				
Days Go By	The Offspring				
Why Can't We Be Friends?	Smash Mouth (original by War)				
Can't Get Enough of You Baby	Smash Mouth				
Oh Love	Green Day				
Brain Stew/Jaded	Green Day				
Good Riddance (Time of Your Life)	Green Day				
Warning	Green Day				
Minority	Green Day				
Down	311				
Beautiful Disaster	311				
Amber	311				
I Ran (So Far Away)	A Flock of Seagulls				
The Stroke	Billy Squier				
Everybody Wants You	Billy Squier				
Come On Eileen	Save Ferris (original by Dexys Midnight Runners)				
All I Wanna Do	Sheryl Crow				
Animal I Have Become	Three Days Grace				
Make Me Smile	Chicago				
Feelin' Stronger Every Day	Chicago				
If You Leave Me Now	Chicago				
What I Got	Sublime				
Wrong Way	Sublime				
Santeria	Sublime				
Ants Marching	Dave Matthews Band				
Mercy	Dave Matthews Band				
So Much to Say	Dave Matthews Band				
I'm Alright	Kenny Loggins				
Footloose	Kenny Loggins				
Geek Stink Breath	Green Day				
Nice Guys Finish Last	Green Day				
Hitchin' a Ride	Green Day				
Sing of the Century	Green Day				
21st Century Breakdown	Green Day				
Before the Lobotomy	Green Day				
Last Night on Earth	Green Day				
Peacemaker	Green Day				
Murder City	Green Day				
¿Viva La Gloria? (Little Girl)	Green Day				
Restless Heart Syndrome	Green Day				
Horseshoes and Handgrenades	Green Day				
The Static Age	Green Day				
American Eulogy	Green Day				
See the Light	Green Day				
American Idiot	Green Day				
Jesus of Suburbia	Green Day				
Holiday	Green Day				
Boulevard of Broken Dreams	Green Day				
Are We the Waiting/St. Jimmy	Green Day				
Give Me Novacaine/She's a Rebel	Green Day				
Extraordinary Girl	Green Day				
Letterbomb	Green Day				
Wake Me Up When September Ends	Green Day				
Homecoming	Green Day				
Whatsername	Green Day				
Burnout	Green Day				
Having a Blast	Green Day				
Chump	Green Day				
Longview	Green Day				
Welcome to Paradise	Green Day				
Pulling Teeth	Green Day				
Basket Case	Green Day				
She	Green Day				
Sassafras Roots	Green Day				
When I Come Around	Green Day				
Coming Clean	Green Day				
Emenius Sleepus	Green Day				
In the End	Green Day				
F.O.D.	Green Day				
Jessica	The Allman Brothers Band				
The Weight (Live)	The Band				
Cold	Crossfade				
Cry Thunder	DragonForce				
I Melt With You	Modern English				
Closer	Nine Inch Nails				
Call Me Maybe	Carly Rae Jepsen				
Sex and Candy	Marcy Playground				
She Talks to Angels	The Black Crowes				
Remedy	The Black Crowes				
Sometimes Salvation	The Black Crowes				
Possum Kingdom	Toadies				
Away	Toadies				
Tyler	Toadies				
The Bitch is Back	Elton John				
Don't Let the Sun Go Down on Me	Elton John				
I'm Still Standing	Elton John				
Helena	My Chemical Romance				
Teenagers	My Chemical Romance				
Sing	My Chemical Romance				
Party Hard	Andrew W.K.				
Tonight Tonight	Hot Chelle Rae				
We Are Young	Fun feat. Janelle Monáe				
Raise Your Glass	P!nk				
Pumped Up Kicks	Foster The People				
Moves Like Jagger	Maroon 5 feat. Christina Aguilera				
Jessie's Girl	Rick Springfield				
I've Done Everything For You	Rick Springfield				
Don't Talk to Strangers	Rick Springfield				
Stronger (What Doesn't Kill You)	Kelly Clarkson				
Cult of Personality	Living Colour				
Spoonman	Soundgarden				
Metal Health (Bang Your Head)	Quiet Riot				
Walk This Way	Aerosmith				
Sweet Emotion	Aerosmith				
Dream On (Live)	Aerosmith				
Legendary Child	Aerosmith				
Love Alot	Aerosmith				
Back in the Saddle	Aerosmith				
The Wicker Man	Iron Maiden				
Once Bitten, Twice Shy	Great White				
So Far Away	Avenged Sevenfold				
More Than Words	Extreme				
Love Hurts	Nazareth (original by The Everly Brothers)				
Glory of Love	Peter Cetera				
Keep On Loving You	REO Speedwagon				
Tainted Love	Soft Cell (original by Gloria Jones)				
Shine	Collective Soul				
A Little Less Sixteen Candles, A Little More Touch Me	Fall Out Boy				
Got You (Where I Want You)	The Flys				
Silent Lucidity	Queensryche				
It's Been Awhile	Staind				
So Far Away	Staind				
Kids in the Street	The All-American Rejects				
Always	Blink-182				
Give It Away	Red Hot Chili Peppers				
Weird Science	Oingo Boingo				
Rosanna	Toto				
Diamond Eyes (Boom-Lay Boom-Lay Boom)	Shinedown				
Jungle Boogie	Kool & The Gang				
Shout	Tears for Fears				
Send the Pain Below	Chevelle				
The Red	Chevelle				
Face to the Floor	Chevelle				
American Pie	Don McLean				
R U Mine?	Arctic Monkeys				
Sheperd of Fire	Avenged Sevenfold				
Something from Nothing	Foo Fighters				
Rize of the Fenix	Tenacious D				
Back to the Shack	Weezer				
I Still Believe	Frank Turner				
Gimme Three Steps	Lynyrd Skynyrd			1973	Southern Rock
Hard to Handle	The Black Crowes			1990	Rock
Limelight	Rush			1981	Prog
Die, All Right!	The Hives			2000	Punk
Interstate Love Song	Stone Temple Pilots			1994	Rock
The Number of the Beast	Iron Maiden			1982	Metal
Action	Sweet			1976	Glam
Last Train to Clarksville	The Monkees			1966	Pop-Rock
All the Small Things	Blink-182			1999	Punk
Don't Look Back in Anger	Oasis			1995	Rock
Live Forever	Oasis			1994	Rock
Wonderwall	Oasis			1995	Rock
Siva	Smashing Pumpkins			1991	Alternative
Working Man	Rush			1974	Prog
Ten Speed (Of God's Blood and Burial)	Coheed and Cambria			2005	Prog
Roam	The B-52's			1989	Pop-Rock
We Care a Lot	Faith No More			1987	Rock
Calling Dr. Love	Kiss			1976	Classic Rock
Complete Control	The Clash			1977	Punk
Truth Hits Everybody	The Police			1978	Rock
Teenage Lobotomy	Ramones			1977	Punk
Sex Type Thing	Stone Temple Pilots			1992	Alternative
El Scorcho	Weezer			1996	Alternative
Why Do You Love Me	Garbage			2005	Pop-Rock
March of the Pigs	Nine Inch Nails			1994	Rock
The Collector	Nine Inch Nails			2005	Rock
The Perfect Drug	Nine Inch Nails			1997	Rock
China Cat Sunflower	Grateful Dead			1969	Classic Rock
Casey Jones	Grateful Dead			1970	Classic Rock
Sugar Magnolia	Grateful Dead			1970	Classic Rock
Truckin'	Grateful Dead			1970	Classic Rock
Franklin's Tower	Grateful Dead			1975	Classic Rock
I Need a Miracle	Grateful Dead			1978	Classic Rock
Crushcrushcrush	Paramore			2007	Pop-Rock
Beethoven's C***	Serj Tankian			2007	Rock
Shockwave	Black Tide			2008	Metal
Blinded by Fear	At the Gates			1995	Metal
D.O.A.	The Haunted			2003	Metal
Thrasher	Evile			2007	Metal
Peace of Mind	Boston			1976	Classic Rock
More Than a Feeling	Boston			1976	Classic Rock
Smokin'	Boston			1976	Classic Rock
Rock and Roll Band	Boston			1976	Classic Rock
Something About You	Boston			1976	Classic Rock
Hitch a Ride	Boston			1976	Classic Rock
Still Alive	GLaDOS			2007	Pop-Rock
Rock Rebellion	Bang Camaro			2007	Rock
Simple Man	Lynyrd Skynyrd			1973	Southern Rock
Message in a Bottle	The Police			1979	Rock
Call Me	Blondie			1981	Pop-Rock
Saints of Los Angeles	Mötley Crüe			2008	Rock
The Hellion/Electric Eye	Judas Priest			1982	Metal
Riding on the Wind	Judas Priest			1982	Metal
Bloodstone	Judas Priest			1982	Metal
(Take These) Chains	Judas Priest			1982	Metal
Pain and Pleasure	Judas Priest			1982	Metal
Screaming for Vengeance	Judas Priest			1982	Metal
You've Got Another Thing Comin'	Judas Priest			1982	Metal
Fever	Judas Priest			1982	Metal
Devil's Child	Judas Priest			1982	Metal
Red Tandy	The Mother Hips			2005	Rock
Time-Sick Son of a Grizzly Bear	The Mother Hips			2007	Rock
Zero	Smashing Pumpkins			1995	Alternative
This Ain't a Scene, It's an Arms Race	Fall Out Boy			2007	Pop-Rock
Date with the Night	Yeah Yeah Yeahs			2003	Rock
It Hurts	Angels & Airwaves			2006	Alternative
Hanging on the Telephone	Blondie			1978	Pop-Rock
Train in Vain (Stand by Me)	The Clash			1979	Punk
Kool Thing	Sonic Youth			1990	Alternative
Beetlebum	Blur			1997	Alternative
Countdown to Insanity	H-Blockx			2007	Rock
Hier Kommt Alex	Die Toten Hosen			1988	Punk
Hysteria	Muse			2003	Alternative
Manu Chao 	Les Wampas			2003	Punk
Monsoon	Tokio Hotel			2005	Glam
New Wave	Pleymo			2002	Metal
Perfekte Welle	Juli			2000s	Rock
Rock 'n' Roll Star	Oasis			1994	Rock
Good Times Roll	The Cars			1978	Rock
My Best Friend's Girl	The Cars			1978	Rock
Just What I Needed	The Cars			1978	Rock
I'm in Touch with Your World	The Cars			1978	Rock
Don't Cha Stop	The Cars			1978	Rock
You're All I've Got Tonight	The Cars			1978	Rock
Bye Bye Love	The Cars			1978	Rock
Moving in Stereo	The Cars			1978	Rock
All Mixed Up	The Cars			1978	Rock
Indestructible	Disturbed			2008	Nu-Metal
Inside the Fire	Disturbed			2008	Nu-Metal
Perfect Insanity	Disturbed			2008	Nu-Metal
Cheeseburger in Paradise	Jimmy Buffett			1978	Rock
Margaritaville	Jimmy Buffett			1977	Rock
Volcano	Jimmy Buffett			1979	Rock
Moving to Seattle	The Material			2007	Alternative
A Clean Shot	The Myriad			2008	Alternative
Bullets & Guns	Them Terribles			2007	Alternative
Girls Who Play Guitars	Maxïmo Park			2007	Pop-Rock
Critical Acclaim	Avenged Sevenfold			2007	Metal
Afterlife	Avenged Sevenfold			2007	Metal
Hammerhead	The Offspring			2008	Rock
Rock n' Roll Dream	Crooked X			2008	Rock
Debaser	Pixies			1989	Alternative
Tame	Pixies			1989	Alternative
I Bleed	Pixies			1989	Alternative
Here Comes Your Man	Pixies			1989	Alternative
Dead	Pixies			1989	Alternative
Monkey Gone to Heaven	Pixies			1989	Alternative
Mr. Grieves	Pixies			1989	Alternative
Crackity Jones	Pixies			1989	Alternative
La La Love You	Pixies			1989	Alternative
No. 13 Baby	Pixies			1989	Alternative
There Goes My Gun	Pixies			1989	Alternative
Hey	Pixies			1989	Alternative
Silver	Pixies			1989	Alternative
Gouge Away	Pixies			1989	Alternative
Dreamin'	Weezer			2008	Alternative
The Greatest Man That Ever Lived	Weezer			2008	Alternative
Troublemaker	Weezer			2008	Alternative
Down at the Whisky	Mötley Crüe			2008	Metal
Time Is Running Out	Papa Roach			2006	Alternative
Who's Going Home with You Tonight?	Trapt			2008	Nu-Metal
Promised Land	Vesuvius			2008	Rock
Snow ((Hey Oh))	Red Hot Chili Peppers			2006	Rock
Tell Me Baby	Red Hot Chili Peppers			2006	Rock
Closer to the Heart	Rush			1977	Prog
Working Man (Vault Edition)	Rush			1974	Prog
Amazing Journey	The Who			1969	Classic Rock
Baba O'Riley	The Who			1971	Classic Rock
Behind Blue Eyes	The Who			1971	Classic Rock
Eminence Front	The Who			1982	Classic Rock
Going Mobile	The Who			1971	Classic Rock
Leaving Here	The Who			1965	Classic Rock
My Generation (Live at Leeds)	The Who			1970	Classic Rock
Real Good Looking Boy	The Who			2004	Classic Rock
Sea and Sand	The Who			1973	Classic Rock
Summertime Blues (Live at Leeds)	The Who			1970	Classic Rock
Who Are You	The Who			1978	Classic Rock
Young Man Blues (Live at Leeds)	The Who			1970	Classic Rock
Burn	Nine Inch Nails			1994	Rock
Capital G	Nine Inch Nails			2007	Rock
Last	Nine Inch Nails			1992	Rock
Devour	Shinedown			2008	Nu-Metal
Junkies for Fame	Shinedown			2008	Nu-Metal
They Say	Scars on Broadway			2008	Rock
This Is It	Staind			2008	Nu-Metal
Electric Crown	Testament			1992	Metal
Yomp	Thenewno2			2008	Pop-Rock
Toxicity 	System of a Down			2002	Metal
B.Y.O.B. 	System of a Down			2005	Alternative
Face Down in the Dirt	Mötley Crüe			2008	Rock
Rescue Me	Buckcherry			2008	Rock
Life Is Beautiful	Sixx:A.M.			2007	Rock
Aesthetics of Hate	Machine Head			2007	Metal
Clouds Over California	DevilDriver			2007	Metal
Constant Motion	Dream Theater			2007	Metal
My Curse	Killswitch Engage			2006	Metal
Sleepwalker	Megadeth			2007	Metal
Runnin' Wild	Airbourne			2007	Rock
Girl U Want (Rock Band Re-Record)	Devo			1980	New Wave
Through Being Cool (Rock Band Re-Record)	Devo			1981	New Wave
Rio	Duran Duran			1982	Pop-Rock
Girls on Film	Duran Duran			1981	Pop-Rock
Get Your Rock On	The Janitors			2008	Pop-Rock
All Over Again 	Locksley			2007	Pop-Rock
She Does 	Locksley			2007	Pop-Rock
Don't Make Me Wait 	Locksley			2007	Pop-Rock
Skullcrusher Mountain	Jonathan Coulton			2004	Pop-Rock
Livin' at the Corner of Dude & Catastrophe	MC Frontalot feat. Brad Sucks			2007	Other
Shhh...	The Darkest of the Hillside Thickets			2008	Rock
This Calling	All That Remains			2006	Metal
Chiron	All That Remains			2008	Metal
Two Weeks	All That Remains			2008	Metal
Charlene (I'm Right Behind You)	Stephen and the Colberts			1986	Pop-Rock
One of THOSE Nights	The Cab			2008	Pop-Rock
Hands Down	Dashboard Confessional			2003	Pop-Rock
She's a Handsome Woman	Panic at the Disco			2008	Pop-Rock
Natural Disaster	Plain White T's			2008	Pop-Rock
Wake Up Dead	Megadeth			1986	Metal
The Conjuring	Megadeth			1986	Metal
Devil's Island	Megadeth			1986	Metal
Good Mourning/Black Friday	Megadeth			1986	Metal
Bad Omen	Megadeth			1986	Metal
I Ain't Superstitious	Megadeth			1986	Metal
My Last Words	Megadeth			1986	Metal
Tom Sawyer (Original Version)	Rush			1981	Prog
Red Barchetta	Rush			1981	Prog
YYZ	Rush			1981	Prog
Limelight (Original Version)	Rush			1981	Prog
The Camera Eye	Rush			1981	Prog
Witch Hunt (Part III of Fear)	Rush			1981	Prog
Vital Signs	Rush			1981	Prog
Sorrow	Bad Religion			2002	Punk
She Sells Sanctuary	The Cult			1985	Rock
Bandages	Hot Hot Heat			2002	Alternative
Shoot the Runner	Kasabian			2006	Alternative
You're No Rock N Roll Fun	Sleater-Kinney			2000	Alternative
Love Spreads	The Stone Roses			1994	Alternative
The Power of Equality 	Red Hot Chili Peppers			1991	Alternative
If You Have to Ask 	Red Hot Chili Peppers			1991	Alternative
Breaking the Girl 	Red Hot Chili Peppers			1991	Alternative
Funky Monks 	Red Hot Chili Peppers			1991	Alternative
Suck My Kiss 	Red Hot Chili Peppers			1991	Alternative
I Could Have Lied 	Red Hot Chili Peppers			1991	Alternative
Mellowship Slinky in B Major 	Red Hot Chili Peppers			1991	Alternative
The Righteous and the Wicked 	Red Hot Chili Peppers			1991	Alternative
Blood Sugar Sex Magik 	Red Hot Chili Peppers			1991	Alternative
Under the Bridge 	Red Hot Chili Peppers			1991	Alternative
Naked in the Rain 	Red Hot Chili Peppers			1991	Alternative
Apache Rose Peacock 	Red Hot Chili Peppers			1991	Alternative
The Greeting Song 	Red Hot Chili Peppers			1991	Alternative
My Lovely Man 	Red Hot Chili Peppers			1991	Alternative
Sir Psycho Sexy 	Red Hot Chili Peppers			1991	Alternative
They're Red Hot 	Red Hot Chili Peppers			1991	Alternative
All Right Now	Free			1970	Classic Rock
Stop!	Against Me!			2007	Punk
Bad to the Bone	George Thorogood & the Destroyers			1982	Rock
Cream and Bastards Rise	Harvey Danger			2005	Alternative
Nearly Lost You	Screaming Trees			1992	Grunge
Push It	Static-X			1999	Metal
Gone Away	The Offspring			1997	Rock
Pretty Fly (For a White Guy)	The Offspring			1998	Rock
Self Esteem	The Offspring			1994	Rock
Dr. Feelgood	Mötley Crüe			1989	Metal
Slice of Your Pie	Mötley Crüe			1989	Metal
Rattlesnake Shake	Mötley Crüe			1989	Metal
Kickstart My Heart	Mötley Crüe			1989	Metal
Without You	Mötley Crüe			1989	Metal
Same Ol' Situation (S.O.S.)	Mötley Crüe			1989	Metal
Sticky Sweet	Mötley Crüe			1989	Metal
She Goes Down	Mötley Crüe			1989	Metal
Don't Go Away Mad (Just Go Away)	Mötley Crüe			1989	Metal
Time for Change	Mötley Crüe			1989	Metal
Breed	Nirvana			1991	Grunge
Lounge Act	Nirvana			1991	Grunge
On a Plain	Nirvana			1991	Grunge
Polly	Nirvana			1991	Grunge
Something in the Way	Nirvana			1991	Grunge
Stay Away	Nirvana			1991	Grunge
Territorial Pissings	Nirvana			1991	Grunge
Hong Kong Garden	Siouxsie and The Banshees			1981	Pop-Rock
Kiss Them for Me	Siouxsie and The Banshees			1991	Pop-Rock
The Killing Jar	Siouxsie and The Banshees			1988	Pop-Rock
Dammit	Blink-182			1997	Punk
Well Thought Out Twinkles	Silversun Pickups			2006	Indie Rock
Melatonin	Silversun Pickups			2006	Indie Rock
Pretty in Pink	The Psychedelic Furs			1981	Rock
Dune Buggy	The Presidents of the United States of America			1995	Pop-Rock
Feather Pluck'n	The Presidents of the United States of America			1995	Pop-Rock
Ladybug	The Presidents of the United States of America			2008	Pop-Rock
Use Me	Hinder			2008	Rock
I Don't Care	Fall Out Boy			2008	Pop-Rock
Ashes to Fire	Ghost Hounds			2008	Rock
Bounce	The Cab			2008	Pop-Rock
Burn You Down	Opiate for the Masses			2008	Rock
Crazy Tuesday	Thenewno2			2008	Pop-Rock
Database Corrupted	Dealership			2004	Indie Rock
Desperate Times, Desperate Measures	Underoath			2008	Metal
Get It On	The Chevelles			2008	Rock
Give It to Me	Cocktail Slippers			2006	Indie Rock
I Wanna Be Your Man	Endeverafter			2007	Rock
I'm Gone, I'm Going	Lesley Roy			2008	Pop-Rock
I.V.	X Japan			2008	Metal
If I Ain't Got You	The Len Price 3			2007	Rock
Like a Fool	Shaimus			2008	Indie Rock
Magnetic Baby	Semi Precious Weapons			2008	Glam
No Regrets	Authority Zero			2007	Punk
Prequel to the Sequel	Between the Buried and Me			2007	Prog
Sons and Daughters	The 88			2008	Pop-Rock
The Feeling	Kutless			2008	Rock
The Time Is Wrong	Tickle Me Pink			2008	Emo
Young	Hollywood Undead			2008	Nu-Metal
Doll	Foo Fighters			1997	Alternative
Monkey Wrench	Foo Fighters			1997	Alternative
Hey, Johnny Park!	Foo Fighters			1997	Alternative
My Poor Brain	Foo Fighters			1997	Alternative
Wind Up	Foo Fighters			1997	Alternative
Up in Arms	Foo Fighters			1997	Alternative
My Hero	Foo Fighters			1997	Alternative
See You	Foo Fighters			1997	Alternative
Enough Space	Foo Fighters			1997	Alternative
February Stars	Foo Fighters			1997	Alternative
Walking After You	Foo Fighters			1997	Alternative
New Way Home	Foo Fighters			1997	Alternative
California Über Alles	Dead Kennedys			1987	Punk
Holiday in Cambodia	Dead Kennedys			1987	Punk
Police Truck	Dead Kennedys			1987	Punk
Mica	Mission of Burma			1982	Punk
That's How I Escaped My Certain Fate	Mission of Burma			1982	Punk
That's When I Reach for My Revolver	Mission of Burma			1981	Punk
Forever	In This Moment			2008	Metal
Closer	Lacuna Coil			2006	Metal
Swamped	Lacuna Coil			2002	Metal
Gone	Crooked X			2008	Metal
Mr. Brightside	The Killers			2004	Alternative
Spaceman	The Killers			2008	Alternative
Smile Like You Mean It	The Killers			2004	Alternative
Caprici Di Diablo	Yngwie Malmsteen's Rising Force			2008	Metal
Damnation Game	Yngwie Malmsteen's Rising Force			2008	Metal
Red Devil	Yngwie Malmsteen's Rising Force			2008	Metal
Jesus Christ Pose	Soundgarden			1991	Grunge
Pretty Noose	Soundgarden			1996	Grunge
Laid to Rest	Lamb of God			2004	Metal
Are You Dead Yet?	Children of Bodom			2005	Metal
Tutto è possibile	Finley			2006	Punk
Hay Poco Rock N Roll	Platero y Tú			1994	Rock
Tempted	Squeeze			1981	Rock
Ready, Set, Go!	Tokio Hotel			2007	Pop-Rock
Real World	All-American Rejects			2008	Emo
Headphones On	Miranda Cosgrove			2008	Pop-Rock
Body I Occupy	The Naked Brothers Band			2008	Pop-Rock
I Don't Want to Go to School	The Naked Brothers Band			2008	Pop-Rock
Just a Girl	No Doubt			1995	Pop-Rock
It's My Life	No Doubt			2003	Pop-Rock
Hey Baby	No Doubt			2003	Pop-Rock
Bathwater	No Doubt			2003	Pop-Rock
Sunday Morning	No Doubt			1995	Pop-Rock
Hella Good	No Doubt			2003	Pop-Rock
Underneath It All	No Doubt			2003	Pop-Rock
Excuse Me Mr.	No Doubt			1995	Pop-Rock
Running	No Doubt			2003	Pop-Rock
Spiderwebs	No Doubt			1995	Pop-Rock
Simple Kind of Life	No Doubt			2003	Pop-Rock
Don't Speak	No Doubt			1995	Pop-Rock
Ex-Girlfriend	No Doubt			2003	Pop-Rock
Mud on the Tires	Brad Paisley			2003	Country
Hillbilly Deluxe	Brooks & Dunn			2005	Country
Free and Easy (Down the Road I Go)	Dierks Bentley			2006	Country
Sin Wagon	Dixie Chicks			1999	Country
Gunpowder & Lead	Miranda Lambert			2007	Country
Hanukkah Blessings	Barenaked Ladies			2004	Rock
Christmas Is the Time to Say I Love You	Billy Squier			1994	Classic Rock
Blue Christmas	The Pretenders			2008	Rock
This Is a Call	Foo Fighters			1995	Alternative
Times Like These	Foo Fighters			2002	Alternative
DOA	Foo Fighters			2005	Alternative
Space Truckin'	Deep Purple			1972	Classic Rock
Funk #49	James Gang			1970	Classic Rock
Hymn 43	Jethro Tull			1971	Prog
Take Back the City	Snow Patrol			2008	Alternative
Fortunate Son	Creedence Clearwater Revival			1960s	Southern Rock
Juke Box Hero	Foreigner			1980s	Classic Rock
Bang a Gong	T. Rex			1970s	Glam
My Sharona	The Knack			1970s	Pop-Rock
Cherry Bomb	The Runaways			1970s	Punk
Joker & the Thief	Wolfmother			2000s	Rock
Ride the Lightning	Metallica			1980s	Metal
Blackened	Metallica			1980s	Metal
...And Justice for All	Metallica			1980s	Metal
3's & 7's	Queens of the Stone Age			2000s	Alternative
Little Sister	Queens of the Stone Age			2000s	Alternative
Sick, Sick, Sick	Queens of the Stone Age			2000s	Alternative
Can't Stand Losing You	The Police			1970s	Pop-Rock
Synchronicity II	The Police			1980s	Pop-Rock
Roxanne	The Police			1970s	Pop-Rock
Heroes	David Bowie			1970s	Glam
Moonage Daydream	David Bowie			1970s	Glam
Queen Bitch	David Bowie			1970s	Glam
N.I.B.	Black Sabbath			1970s	Metal
Sweet Leaf	Black Sabbath			1970s	Metal
War Pigs	Black Sabbath			1970s	Metal
Ever Fallen in Love	Buzzcocks			1970s	Punk
I Fought the Law	The Clash			1970s	Punk
Rockaway Beach	Ramones			1970s	Punk
My Iron Lung	Radiohead			1990s	Alternative
Brass in Pocket	The Pretenders			1980s	Pop-Rock
Buddy Holly	Weezer			1990s	Alternative
Attack	30 Seconds to Mars			2000s	Rock
The Kill	30 Seconds to Mars			2000s	Rock
Dirty Little Secret	All-American Rejects			2000s	Rock
Move Along	All-American Rejects			2000s	Rock
Song with a Mission	The Sounds			2000s	Alternative
Claudette	Roy Orbison			1980s	Pop-Rock
In Dreams	Roy Orbison			1980s	Pop-Rock
Mean Woman Blues	Roy Orbison			1980s	Pop-Rock
Oh, Pretty Woman	Roy Orbison			1980s	Pop-Rock
Ooby Dooby	Roy Orbison			1980s	Pop-Rock
You Got It	Roy Orbison			1980s	Pop-Rock
Are You Gonna Go My Way	Lenny Kravitz			1990s	Rock
Freedom Train	Lenny Kravitz			1980s	Rock
Let Love Rule	Lenny Kravitz			1980s	Rock
Mr. Cab Driver	Lenny Kravitz			1980s	Rock
Megasus	Megasus			2000s	Metal
Entangled	Honest Bob and the Factory-to-Dealer Incentives			2000s	Indie Rock
Space Cowboy	Steve Miller Band			1960s	Classic Rock
Take the Money and Run	Steve Miller Band			1970s	Classic Rock
The Joker	Steve Miller Band			1970s	Classic Rock
I Stand Alone	Godsmack			2000s	Nu-Metal
Feed the Tree	Belly			1990s	Alternative
Wind Me Up	Ghost Hounds			2000s	Rock
Typical	Mute Math			2000s	Alternative
War Zone	Rob Zombie			2000s	Nu-Metal
Cold Rain and Snow	Grateful Dead			1960s	Classic Rock
Doin' That Rag	Grateful Dead			1960s	Classic Rock
Don't Ease Me In	Grateful Dead			1980s	Classic Rock
Fire on the Mountain	Grateful Dead			1970s	Classic Rock
Hell in a Bucket	Grateful Dead			1980s	Classic Rock
Uncle John's Band	Grateful Dead			1970s	Classic Rock
The Boys Are Back in Town (Live)	Thin Lizzy			2000s	Classic Rock
Cowboy Song (Live)	Thin Lizzy			2000s	Classic Rock
Jailbreak (Live)	Thin Lizzy			2000s	Classic Rock
Precious	The Pretenders			1980s	Punk
Hit Me With Your Best Shot	Pat Benatar			1980s	Classic Rock
Break My Heart	Nikko			2000s	Pop-Rock
Don't Tell Me	Nikko			2000s	Pop-Rock
Creepin' Up the Backstairs	The Fratellis			2000s	Alternative
Flathead	The Fratellis			2000s	Alternative
Henrietta	The Fratellis			2000s	Alternative
More Human than Human	White Zombie			1990s	Metal
Black Sunshine	White Zombie			1990s	Metal
Wasted Again	Turbonegro			2000s	Punk
3 Dimes Down	Drive-By Truckers			2000s	Country
Can't Let Go	Lucinda Williams			1990s	Country
People Got a Lotta Nerve	Neko Case			2000s	Country
Time Bomb (Live)	Old 97s			2000s	Country
Satellite Radio	Steve Earle			2000s	Country
Futures	Jimmy Eat World			2000s	Pop-Rock
Lucky Denver Mint	Jimmy Eat World			1990s	Pop-Rock
Sweetness	Jimmy Eat World			2000s	Pop-Rock
New	No Doubt			2000s	Pop-Rock
Love Struck Baby	Stevie Ray Vaughan and Double Trouble			1980s	Blues
Pride and Joy	Stevie Ray Vaughan and Double Trouble			1980s	Blues
Texas Flood	Stevie Ray Vaughan and Double Trouble			1980s	Blues
Tell Me	Stevie Ray Vaughan and Double Trouble			1980s	Blues
Testify	Stevie Ray Vaughan and Double Trouble			1980s	Blues
Rude Mood	Stevie Ray Vaughan and Double Trouble			1980s	Blues
Mary Had a Little Lamb	Stevie Ray Vaughan and Double Trouble			1980s	Blues
Dirty Pool	Stevie Ray Vaughan and Double Trouble			1980s	Blues
I'm Cryin'	Stevie Ray Vaughan and Double Trouble			1980s	Blues
Lenny	Stevie Ray Vaughan and Double Trouble			1980s	Blues
All I Want	The Offspring			1990s	Punk
The Kids Aren't Alright	The Offspring			1990s	Punk
Losing My Religion	R.E.M.			1990s	Alternative
The Way That It Shows	Richard Thompson			1990s	Rock
Pick Up the Pieces	Average White Band			1970s	R&B/Soul/Funk
Shining Star	Earth, Wind & Fire			1970s	R&B/Soul/Funk
Get Up (I Feel Like Being a) Sex Machine - Pt 1	James Brown			1970s	R&B/Soul/Funk
Thrash Unreal	Against Me!			2000s	Punk
All the Things That Go to Make Heaven and Earth	The New Pornographers			2000s	Indie Rock
Use It	The New Pornographers			2000s	Indie Rock
Last Resort	Papa Roach			2000s	Alternative
Lifeline	Papa Roach			2000s	Alternative
Once	Pearl Jam			1990s	Grunge
Even Flow	Pearl Jam			1990s	Grunge
Why Go	Pearl Jam			1990s	Grunge
Black	Pearl Jam			1990s	Grunge
Jeremy	Pearl Jam			1990s	Grunge
Oceans	Pearl Jam			1990s	Grunge
Porch	Pearl Jam			1990s	Grunge
Garden	Pearl Jam			1990s	Grunge
Deep	Pearl Jam			1990s	Grunge
Release	Pearl Jam			1990s	Grunge
Master/Slave	Pearl Jam			1990s	Grunge
Don't Stop Believing	Journey			1980s	Classic Rock
Heartbreaker	Pat Benatar			1970s	Classic Rock
Geraldine	Glasvegas			2000s	Alternative
C'mon C'mon	The Von Bondies			2000s	Alternative
I Can't Keep My Eyes Off of You	SpongeBob SquarePants			2000s	Other
The Best Day Ever	SpongeBob SquarePants			2000s	Other
Where's Gary?	SpongeBob SquarePants			2000s	Other
New Slang	The Shins			2000s	Indie Rock
Warriors of Time	Black Tide			2000s	Metal
Waking the Demon	Bullet for My Valentine			2000s	Metal
Beer for My Horses	Toby Keith			2000s	Country
I Love This Bar	Toby Keith			2000s	Country
She's a Hottie	Toby Keith			2000s	Country
Should've Been a Cowboy	Toby Keith			1990s	Country
Who's Your Daddy?	Toby Keith			2000s	Country
How Do You Like Me Now?!	Toby Keith			1990s	Country
Chinese Democracy	Guns N' Roses			2000s	Rock
Better	Guns N' Roses			2000s	Rock
Street of Dreams	Guns N' Roses			2000s	Rock
If the World	Guns N' Roses			2000s	Rock
There Was a Time	Guns N' Roses			2000s	Rock
Catcher in the Rye	Guns N' Roses			2000s	Rock
Scraped	Guns N' Roses			2000s	Rock
Riad N' the Bedouins	Guns N' Roses			2000s	Rock
Sorry	Guns N' Roses			2000s	Rock
I.R.S.	Guns N' Roses			2000s	Rock
Madagascar	Guns N' Roses			2000s	Rock
This I Love	Guns N' Roses			2000s	Rock
Prostitute	Guns N' Roses			2000s	Rock
Riding the Storm Out	REO Speedwagon			1980s	Rock
Roll with the Changes	REO Speedwagon			1980s	Rock
Take It on the Run	REO Speedwagon			1980s	Rock
Blue Collar Man (Long Nights)	Styx			2000s	Classic Rock
Renegade	Styx			2000s	Classic Rock
Too Much Time on My Hands	Styx			2000s	Classic Rock
Can't Stop Rockin'	Styx/REO Speedwagon			2000s	Rock
Alone in My Head	Hautewerk			2000s	Indie Rock
I Know Where You Came From	Hautewerk			2000s	Indie Rock
Stop Start Again	Hautewerk			2000s	Indie Rock
Up the Beach	Jane's Addiction			1980s	Alternative
Ocean Size	Jane's Addiction			1980s	Alternative
Had a Dad	Jane's Addiction			1980s	Alternative
Ted, Just Admit It...	Jane's Addiction			1980s	Alternative
Standing in the Shower... Thinking	Jane's Addiction			1980s	Alternative
Summertime Rolls	Jane's Addiction			1980s	Alternative
Idiots Rule	Jane's Addiction			1980s	Alternative
Jane Says	Jane's Addiction			1980s	Alternative
Thank You Boys	Jane's Addiction			1980s	Alternative
Pig's in Zen	Jane's Addiction			1980s	Alternative
Take Me Out	Franz Ferdinand			2000s	Alternative
Lucid Dreams	Franz Ferdinand			2000s	Alternative
Do You Want To	Franz Ferdinand			2000s	Alternative
Smooth Criminal	Alien Ant Farm			2000s	Rock
Blue Sky	The Allman Brothers Band			1970s	Southern Rock
Midnight Rider	The Allman Brothers Band			1970s	Southern Rock
Drain the Blood	The Distillers			2000s	Punk
Naked Eye	Luscious Jackson			1990s	Alternative
Idealistic Types	Prong			2000s	Metal
The Banishment	Prong			2000s	Metal
Bad Luck	Social Distortion			1990s	Punk
Ring of Fire	Social Distortion			1990s	Punk
Story of My Life	Social Distortion			1990s	Punk
Stricken	Disturbed			2000s	Nu-Metal
Stupify	Disturbed			2000s	Nu-Metal
Black Friday	Steely Dan			1970s	Classic Rock
My Old School	Steely Dan			1970s	Classic Rock
Radio Radio	Elvis Costello			1970s	Rock
School's Out (Live)	Alice Cooper			1990s	Rock
I'm Eighteen (Live)	Alice Cooper			1990s	Rock
Billion Dollar Babies (Live)	Alice Cooper			1990s	Rock
Poison	Alice Cooper			1980s	Rock
Under My Wheels (Live)	Alice Cooper			1990s	Rock
Vengeance is Mine	Alice Cooper			2000s	Rock
Liar (It Takes One to Know One)	Taking Back Sunday			2000s	Emo
MakeDamnSure	Taking Back Sunday			2000s	Emo
What's It Feel Like to Be a Ghost?	Taking Back Sunday			2000s	Emo
Kids Don't Follow	The Replacements			1980s	Punk
Cuz U R Next	Ministry			2000s	Metal
LiesLiesLies	Ministry			2000s	Metal
The Great Satan	Ministry			2000s	Metal
She's Not There	The Zombies			1960s	Pop-Rock
Tell Her No	The Zombies			1960s	Pop-Rock
Linger	The Cranberries			1990s	Alternative
Shimmer & Shine	Ben Harper and Relentless7			2000s	Alternative
A Favor House Atlantic	Coheed and Cambria			2000s	Prog
The Running Free	Coheed and Cambria			2000s	Prog
Wilson (Live)	Phish			1990s	Rock
Steady at the Wheel	Shooter Jennings			2000s	Country
Wolf Like Me	TV on the Radio			2000s	Indie Rock
Aces High (Live)	Iron Maiden			2000s	Metal
2 Minutes to Midnight	Iron Maiden			1980s	Metal
The Trooper	Iron Maiden			1980s	Metal
Wasted Years	Iron Maiden			1980s	Metal
The Number of the Beast (Original Version)	Iron Maiden			1980s	Metal
Run to the Hills (Original Version)	Iron Maiden			1980s	Metal
Can I Play with Madness	Iron Maiden			1980s	Metal
The Clairvoyant	Iron Maiden			1980s	Metal
Powerslave	Iron Maiden			1980s	Metal
Fear of the Dark (Live)	Iron Maiden			2000s	Metal
Hallowed Be Thy Name (Live)	Iron Maiden			2000s	Metal
Iron Maiden (Live)	Iron Maiden			2000s	Metal
Bring Me to Life	Evanescence			2000s	Nu-Metal
Call Me When You're Sober	Evanescence			2000s	Nu-Metal
Weight of the World	Evanescence			2000s	Nu-Metal
Back from the Dead	Spinal Tap			2000s	Rock
Rock 'n' Roll Nightmare	Spinal Tap			2000s	Rock
Saucy Jack	Spinal Tap			2000s	Rock
Warmer Than Hell	Spinal Tap			2000s	Rock
The Downfall of Us All	A Day to Remember			2000s	Punk
21st Century (Digital Boy)	Bad Religion			1990s	Punk
I Didn't Say I Was Powerful, I Said I Was a Wizard	Chiodos			2000s	Emo
The Flood	Escape the Fate			2000s	Emo
Reinventing Your Exit	Underoath			2000s	Emo
Little of Your Time	Maroon 5			2000s	Pop-Rock
Makes Me Wonder	Maroon 5			2000s	Pop-Rock
Wake Up Call	Maroon 5			2000s	Pop-Rock
Brother	Pearl Jam			2000s	Grunge
Alive (Live: Drop in the Park)	Pearl Jam			2000s	Grunge
State of Love and Trust (Live: Drop in the Park)	Pearl Jam			2000s	Grunge
Blue Morning, Blue Day	Foreigner			1970s	Classic Rock
Feels Like the First Time	Foreigner			1970s	Classic Rock
Headknocker	Foreigner			1970s	Classic Rock
Weapon of Choice	Black Rebel Motorcycle Club			2000s	Alternative
Sweet Talk	Dear and the Headlights			2000s	Indie Rock
Hey John, What's Your Name Again?	The Devil Wears Prada			2000s	Metal
Image of the Invisible	Thrice			2000s	Rock
21 Guns	Green Day			2000s	Rock
East Jesus Nowhere	Green Day			2000s	Rock
Know Your Enemy	Green Day			2000s	Rock
Conquer All	Behemoth			2000s	Metal
What a Horrible Night to Have a Curse	The Black Dahlia Murder			2000s	Metal
Hammer Smashed Face	Cannibal Corpse			1990s	Metal
Empire of the Gun	God Forbid			2000s	Metal
Embedded	Job for a Cowboy			2000s	Metal
Disposable Teens	Marilyn Manson			2000s	Glam
Black Magic	Slayer			1980s	Metal
This Is Exile	Whitechapel			2000s	Metal
All Going Out Together	Big Dipper			2000s	Indie Rock
She's Fetching	Big Dipper			2000s	Indie Rock
Younger Bums	Big Dipper			2000s	Indie Rock
Dissident Aggressor (Live)	Judas Priest			2000s	Metal
Eat Me Alive (Live)	Judas Priest			2000s	Metal
Prophecy (Live)	Judas Priest			2000s	Metal
Hang You from the Heavens	The Dead Weather			2000s	Alternative
No Hassle Night	The Dead Weather			2000s	Alternative
Treat Me Like Your Mother	The Dead Weather			2000s	Alternative
Crawl	Kings of Leon			2000s	Rock
Molly's Chambers	Kings of Leon			2000s	Rock
Sex on Fire	Kings of Leon			2000s	Rock
Last One to Die	Rancid			2000s	Punk
Ruby Soho	Rancid			1990s	Punk
Time Bomb	Rancid			1990s	Punk
Prayer of the Refugee	Rise Against			2000s	Punk
Re-Education (Through Labor)	Rise Against			2000s	Punk
Savior	Rise Against			2000s	Punk
Sweetness & Light	Lush			1990s	Alternative
Down	Blink-182			2000s	Punk
Feeling This	Blink-182			2000s	Punk
The Rock Show	Blink-182			2000s	Punk
100,000 Years (Live)	Kiss			1970s	Classic Rock
Deuce (Live)	Kiss			1970s	Classic Rock
Parasite (Live)	Kiss			1970s	Classic Rock
My Name Is Jonas	Weezer			1990s	Alternative
Pork and Beans	Weezer			2000s	Alternative
Undone - The Sweater Song	Weezer			1990s	Alternative
Out Here All Night	Damone			2000s	Rock
(Funky) Sex Farm	Spinal Tap			2000s	Metal
(Listen to the) Flower People (Reggae Stylee)	Spinal Tap			2000s	Metal
America	Spinal Tap			2000s	Metal
Big Bottom	Spinal Tap			2000s	Metal
Cups and Cakes	Spinal Tap			2000s	Metal
Gimme Some Money	Spinal Tap			2000s	Metal
Heavy Duty	Spinal Tap			2000s	Metal
Hell Hole	Spinal Tap			2000s	Metal
Rock 'n' Roll Creation	Spinal Tap			2000s	Metal
Stonehenge	Spinal Tap			2000s	Metal
Tonight I'm Gonna Rock You Tonight	Spinal Tap			2000s	Metal
Clint Eastwood	Gorillaz			2000s	Alternative
Feel Good Inc.	Gorillaz			2000s	Alternative
Re-Hash	Gorillaz			2000s	Alternative
Piece of My Heart	Janis Joplin			1970s	Classic Rock
Chest Fever (Live)	The Band			1970s	Classic Rock
White Rabbit	Jefferson Airplane			1960s	Classic Rock
Magic Bus (Live at Leeds)	The Who			1970s	Classic Rock
No Rain	Blind Melon			1990s	Alternative
There's No Other Way	Blur			1990s	Alternative
I'm Shipping Up to Boston	Dropkick Murphys			2000s	Punk
Inside Out	Eve 6			1990s	Alternative
I Predict a Riot	Kaiser Chiefs			2000s	Indie Rock
All My Life	Foo Fighters			2000s	Alternative
I'll Stick Around	Foo Fighters			1990s	Alternative
Lonely as You	Foo Fighters			2000s	Alternative
Mony Mony	Billy Idol			1980s	Rock
Rebel Yell	Billy Idol			1980s	Rock
Don't Stop	Fleetwood Mac			1970s	Classic Rock
World Turning	Fleetwood Mac			1970s	Classic Rock
She's a Genius	Jet			2000s	Alternative
I Won't Back Down	Tom Petty			1980s	Classic Rock
Runnin' Down a Dream	Tom Petty			1980s	Classic Rock
Bat Country	Avenged Sevenfold			2000s	Metal
Town Called Malice	The Jam			1980s	New Wave
Going Underground	The Jam			2000s	New Wave
Supersonic (Live)	Oasis			2000s	Rock
Guerrilla Radio	Rage Against the Machine			1990s	Alternative
And She Was	Talking Heads			1980s	New Wave
Crosseyed and Painless	Talking Heads			1980s	New Wave
Girlfriend Is Better	Talking Heads			1980s	New Wave
Once in a Lifetime	Talking Heads			1980s	New Wave
Take Me to the River	Talking Heads			1970s	New Wave
Get Ready 2 Rokk	Freezepop			2000s	Pop-Rock
Science Genius Girl	Freezepop			2000s	Pop-Rock
Re: Your Brains	Jonathan Coulton			2000s	Pop-Rock
Origin of Species	MC Frontalot			2000s	Other
Opening Band	Paul and Storm			2000s	Pop-Rock
Kryptonite	3 Doors Down			2000s	Rock
Miss Murder	AFI			2000s	Alternative
Gasoline	Audioslave			2000s	Rock
ABC	Jackson 5			1970s	Pop-Rock
666	Anvil			2000s	Metal
Metal on Metal	Anvil			2000s	Metal
This is Thirteen	Anvil			2000s	Metal
Pick Me Up	Dinosaur Jr.			2000s	Alternative
The Wagon	Dinosaur Jr.			1990s	Alternative
Hand Me Down World	The Guess Who			1970s	Classic Rock
No Time	The Guess Who			1970s	Classic Rock
Rock Your Socks	Tenacious D			2000s	Rock
Tribute	Tenacious D			2000s	Rock
Gonna See My Friend	Pearl Jam			2000s	Grunge
Got Some	Pearl Jam			2000s	Grunge
The Fixer	Pearl Jam			2000s	Grunge
Johnny Guitar	Pearl Jam			2000s	Grunge
Just Breathe	Pearl Jam			2000s	Grunge
Amongst the Waves	Pearl Jam			2000s	Grunge
Unthought Known	Pearl Jam			2000s	Grunge
Supersonic	Pearl Jam			2000s	Grunge
Speed of Sound	Pearl Jam			2000s	Grunge
Force of Nature	Pearl Jam			2000s	Grunge
The End	Pearl Jam			2000s	Grunge
A Looking in View	Alice in Chains			2000s	Grunge
Check My Brain	Alice in Chains			2000s	Grunge
No Excuses	Alice in Chains			1990s	Grunge
Rooster	Alice in Chains			1990s	Grunge
Would?	Alice in Chains			1990s	Grunge
I Will Not Bow	Breaking Benjamin			2000s	Nu-Metal
So Cold	Breaking Benjamin			2000s	Nu-Metal
The Diary of Jane	Breaking Benjamin			2000s	Nu-Metal
U Suck	Just Kait			2000s	Rock
Hey Dude	Kula Shaker			1990s	Alternative
Knight on the Town	Kula Shaker			1990s	Alternative
Many Shades of Black	The Raconteurs			2000s	Rock
Salute Your Solution	The Raconteurs			2000s	Rock
Steady, As She Goes	The Raconteurs			2000s	Rock
Dance Epidemic	Electric Six			2000s	Rock
Gay Bar	Electric Six			2000s	Rock
I Don't Like You	Electric Six			2000s	Rock
Head Over Feet	Alanis Morissette			1990s	Pop-Rock
Ironic	Alanis Morissette			1990s	Pop-Rock
Handlebars	Flobots			2000s	Alternative
(We Are) The Road Crew '08	Motörhead			2000s	Metal
The Metal	Tenacious D			2000s	Rock
More Than Meets the Eye	Testament			2000s	Metal
Show Me the Way	Black Tide			2000s	Metal
What's My Age Again?	Blink-182			1990s	Punk
Satch Boogie	Joe Satriani			1980s	Rock
Surfing with the Alien	Joe Satriani			1980s	Rock
Icarus - Borne on the Wings of Steel (Live)	Kansas			1970s	Prog
Point of Know Return (Live)	Kansas			1970s	Prog
Andres	L7			1990s	Grunge
Another One Bites the Dust	Queen			1980s	Classic Rock
Crazy Little Thing Called Love	Queen			1980s	Classic Rock
One Vision	Queen			1980s	Classic Rock
Fat Bottomed Girls	Queen			1970s	Classic Rock
I Want It All	Queen			1980s	Classic Rock
I Want to Break Free	Queen			1980s	Classic Rock
Killer Queen	Queen			1970s	Classic Rock
Somebody to Love	Queen			1970s	Classic Rock
Tie Your Mother Down	Queen			1970s	Classic Rock
Under Pressure	Queen			1980s	Classic Rock
Dragula	Rob Zombie			1990s	Nu-Metal
Burn	Rob Zombie			2000s	Nu-Metal
Superbeast	Rob Zombie			1990s	Nu-Metal
White Unicorn	Wolfmother			2000s	Rock
New Moon Rising	Wolfmother			2000s	Rock
Pilgrim	Wolfmother			2000s	Rock
Sundial	Wolfmother			2000s	Rock
Woman	Wolfmother			2000s	Rock
Rock Me	Liz Phair			2000s	Pop-Rock
Best of Me	Morningwood			2000s	Pop-Rock
Sugarbaby	Morningwood			2000s	Pop-Rock
Best of You	Foo Fighters			2000s	Alternative
The Pretender	Foo Fighters			2000s	Alternative
Wheels	Foo Fighters			2000s	Alternative
Word Forward	Foo Fighters			2000s	Alternative
About a Girl	Nirvana			1980s	Grunge
Blew	Nirvana			1980s	Grunge
School	Nirvana			1980s	Grunge
Fake Friends	Joan Jett & The Blackhearts			1980s	Punk
A Day Like This	SpongeBob SquarePants			2000s	Other
Employee of the Month	SpongeBob SquarePants			2000s	Other
Ridin' the Hook	SpongeBob SquarePants			2000s	Other
Dead Leaves and the Dirty Ground	The White Stripes			2000s	Rock
Girl, You Have No Faith in Medicine	The White Stripes			2000s	Rock
Icky Thump	The White Stripes			2000s	Rock
Smash It Up (Part II)	The Damned			1970s	Punk
Club Foot	Kasabian			2000s	Rock
Beautiful Thieves	AFI			2000s	Alternative
End Transmission	AFI			2000s	Alternative
Love Like Winter	AFI			2000s	Alternative
Medicate	AFI			2000s	Alternative
The Leaving Song Pt. II	AFI			2000s	Alternative
Walk Like An Egyptian	The Bangles			1980s	Rock
New Fang	Them Crooked Vultures			2000s	Rock
A Thing About You (Live)	Tom Petty and the Heartbreakers			2000s	Rock
American Girl (Live)	Tom Petty and the Heartbreakers			2000s	Rock
Even the Losers (Live)	Tom Petty and the Heartbreakers			2000s	Rock
Here Comes My Girl (Live)	Tom Petty and the Heartbreakers			2000s	Rock
Mary Jane's Last Dance (Live)	Tom Petty and the Heartbreakers			2000s	Rock
Refugee (Live)	Tom Petty and the Heartbreakers			2000s	Rock
Miss Independent	Kelly Clarkson			2000s	Pop-Rock
Who Knew	Pink			2000s	Pop-Rock
Our Lips Are Sealed	The Go-Go's			1980s	Pop-Rock
Come As You Are (Live from MTV Unplugged)	Nirvana			1990s	Grunge
Lithium (Live at Reading)	Nirvana			2000s	Grunge
Smells Like Teen Spirit	Nirvana			1990s	Grunge
(You Can Still) Rock in America	Night Ranger			2000s	Rock
Don't Tell Me You Love Me	Night Ranger			2000s	Rock
You're Gonna Hear It From Me	Night Ranger			2000s	Rock
Duality	Slipknot			2000s	Nu-Metal
Psychosocial	Slipknot			2000s	Nu-Metal
Sulfur	Slipknot			2000s	Nu-Metal
I Am a Rock	Simon & Garfunkel			1960s	Classic Rock
The Sounds of Silence	Simon & Garfunkel			1960s	Classic Rock
Dreaming of Love	Lights Resolve			2000s	Indie Rock
Christian's Inferno	Green Day			2000s	Rock
Last of the American Girls	Green Day			2000s	Rock
¡Viva la Gloria!	Green Day			2000s	Rock
Kings and Queens	30 Seconds to Mars			2000s	Emo
This Is War	30 Seconds to Mars			2000s	Emo
Gives You Hell	All-American Rejects			2000s	Emo
(If You're Wondering If I Want You To) I Want You To	Weezer			2000s	Rock
Beverly Hills	Weezer			2000s	Rock
Let It All Hang Out	Weezer			2000s	Rock
Build a Bridge	Limp Bizkit			2000s	Nu-Metal
A Lot Like Me	The Offspring			2000s	Rock
Ocean Avenue	Yellowcard			2000s	Emo
Any Man of Mine	Shania Twain			1990s	Country
Cry Lonely	Cross Canadian Ragweed			2000s	Country
Good Time	Alan Jackson			2000s	Country
I Told You So	Keith Urban			2000s	Country
She's Country	Jason Aldean			2000s	Country
The Gambler	Kenny Rogers			1970s	Country
This One's for the Girls	Martina McBride			2000s	Country
Band on the Run (Live)	Paul McCartney			2000s	Rock
Jet (Live)	Paul McCartney			2000s	Rock
Sing the Changes (Live)	Paul McCartney			2000s	Rock
Adam's Song	Blink-182			1990s	Punk
First Date	Blink-182			2000s	Punk
I Miss You	Blink-182			2000s	Punk
Love My Way	The Psychedelic Furs			1980s	New Wave
Sister Europe	The Psychedelic Furs			1980s	New Wave
Rock 'n' Roll High School	Ramones			2000s	Punk
Grind	Alice in Chains			1990s	Grunge
Heaven Beside You	Alice in Chains			1990s	Grunge
Last of My Kind	Alice in Chains			2000s	Grunge
We Die Young	Alice in Chains			1990s	Grunge
Your Decision	Alice in Chains			2000s	Grunge
A Woman in Love (It's Not Me) (Live)	Tom Petty and the Heartbreakers			2000s	Rock
Breakdown (Live)	Tom Petty and the Heartbreakers			2000s	Rock
Century City (Live)	Tom Petty and the Heartbreakers			2000s	Rock
Jammin' Me (Live)	Tom Petty and the Heartbreakers			2000s	Rock
Nightwatchman (Live)	Tom Petty and the Heartbreakers			2000s	Rock
The Waiting (Live)	Tom Petty and the Heartbreakers			2000s	Rock
1901	Phoenix			2000s	Alternative
Lisztomania	Phoenix			2000s	Alternative
Blue Jeans	Silvertide			2000s	Rock
Bulls on Parade	Rage Against the Machine			1990s	Alternative
Hair of the Dog	Nazareth			1970s	Rock
Killed by Death '08	Motörhead			2000s	Metal
Levitate	I Mother Earth			1990s	Alternative
Master of the Universe	Hawkwind			1970s	Rock
Transmaniacon MC	Blue Öyster Cult			1970s	Classic Rock
Godzilla	Blue Öyster Cult			1970s	Classic Rock
Gone	Montgomery Gentry			2000s	Country
Me and My Gang	Rascal Flatts			2000s	Country
On the Road Again	Willie Nelson			1980s	Country
She Thinks My Tractor's Sexy	Kenny Chesney			1990s	Country
Swing	Trace Adkins			2000s	Country
Suds in the Bucket	Sara Evans			2000s	Country
The Who Super Bowl S-mashup	The Who			2010s	Classic Rock
Holy Wars... The Punishment Due	Megadeth			1990s	Metal
Hangar 18	Megadeth			1990s	Metal
Take No Prisoners	Megadeth			1990s	Metal
Five Magics	Megadeth			1990s	Metal
Poison Was the Cure	Megadeth			1990s	Metal
Lucretia	Megadeth			1990s	Metal
Tornado of Souls	Megadeth			1990s	Metal
Dawn Patrol	Megadeth			1990s	Metal
Rust In Peace... Polaris	Megadeth			1990s	Metal
(Sittin' on the) Dock of the Bay (Take 2)	Otis Redding			1990s	Other
Fa-Fa-Fa-Fa-Fa (Sad Song)	Otis Redding			1960s	Other
I'm Sick Y'all	Otis Redding			1960s	Other
I've Got Dreams to Remember	Otis Redding			1990s	Other
Love Man	Otis Redding			1960s	Other
Weightless	All Time Low			2000s	Pop-Rock
Fascination	Alphabeat			2000s	Pop-Rock
Stray Cat Strut	Brian Setzer			1980s	Jazz
Let Forever Be	The Chemical Brothers			1990s	Other
Heartkiller	HIM			2010s	Alternative
Ode to Solitude	HIM			2010s	Alternative
Wings of a Butterfly	HIM			2000s	Alternative
Distracted	KSM			2000s	Pop-Rock
The Dope Show	Marilyn Manson			1990s	Alternative
Just for Tonight	One Night Only			2000s	Pop-Rock
Walking on the Moon	The Police			1970s	Pop-Rock
Meaning of Life	Disturbed			2000s	Nu-Metal
The Game	Disturbed			2000s	Nu-Metal
Voices	Disturbed			2000s	Nu-Metal
Third Floor Story	The Mother Hips			2000s	Rock
White Falcon Fuzz	The Mother Hips			2000s	Rock
Panic Switch	Silversun Pickups			2000s	Indie Rock
Sort Of	Silversun Pickups			2000s	Indie Rock
Downfall	TRUSTCompany			2000s	Nu-Metal
Decent Days and Nights	The Futureheads			2000s	Punk
Hounds of Love	The Futureheads			2000s	Punk
Walk Away	The James Gang			1970s	Rock
The Hockey Theme	Neil Peart			2000s	Other
All of This	Shaimus			2000s	Indie Rock
Tie You Down	Shaimus			2000s	Indie Rock
Fell in Love with a Girl	The White Stripes			2000s	Rock
Seven Nation Army	The White Stripes			2000s	Rock
You Don't Know What Love Is (You Just Do as You're Told)	The White Stripes			2000s	Rock
Bad Romance	Lady Gaga			2000s	Pop-Rock
Monster	Lady Gaga			2000s	Pop-Rock
Poker Face	Lady Gaga			2000s	Pop-Rock
Just Dance	Lady Gaga			2000s	Pop-Rock
Lady Gaga's Poker Face (South Park Version)	Eric Cartman			2000s	Novelty
It's Not My Time	3 Doors Down			2000s	Rock
Control	Mute Math			2000s	Alternative
Oh Yeah	The Subways			2000s	Alternative
Rock & Roll Queen	The Subways			2000s	Alternative
Blue Spark	X			1980s	Punk
The Hungry Wolf	X			1980s	Punk
I Must Not Think Bad Thoughts	X			1980s	Punk
Los Angeles	X			1980s	Punk
Am I Crazy	Little Fish			2010s	Indie Rock
Bang Bang	Little Fish			2010s	Indie Rock
Darling Dear	Little Fish			2010s	Indie Rock
Outer Space	Ace Frehley			2000s	Metal
All-American Girl	Carrie Underwood			2000s	Country
Stop & Stare	OneRepublic			2000s	Pop-Rock
Up From the Skies	The Jimi Hendrix Experience			1960s	Classic Rock
Spanish Castle Magic	The Jimi Hendrix Experience			1960s	Classic Rock
Wait Until Tomorrow	The Jimi Hendrix Experience			1960s	Classic Rock
Ain't No Telling	The Jimi Hendrix Experience			1960s	Classic Rock
Little Wing	The Jimi Hendrix Experience			1960s	Classic Rock
If 6 Was 9	The Jimi Hendrix Experience			1960s	Classic Rock
You Got Me Floatin'	The Jimi Hendrix Experience			1960s	Classic Rock
Castles Made of Sand	The Jimi Hendrix Experience			1960s	Classic Rock
She's So Fine	The Jimi Hendrix Experience			1960s	Classic Rock
One Rainy Wish	The Jimi Hendrix Experience			1960s	Classic Rock
Little Miss Lover	The Jimi Hendrix Experience			1960s	Classic Rock
Bold as Love	The Jimi Hendrix Experience			1960s	Classic Rock
Valleys of Neptune	Jimi Hendrix			2010s	Classic Rock
Feel Good Drag	Anberlin			2000s	Alternative
Live Life Loud	Hawk Nelson			2000s	Pop-Rock
Monster	Skillet			2000s	Rock
Stand in the Rain	Superchick			2000s	Pop-Rock
Meant to Live	Switchfoot			2000s	Alternative
Fire It Up	Thousand Foot Krutch			2000s	Nu-Metal
Empty Walls	Serj Tankian			2000s	Rock
Sky Is Over	Serj Tankian			2000s	Rock
All-Star	Smash Mouth			1990s	Pop-Rock
Blood on My Hands	The Used			2000s	Emo
Born to Quit	The Used			2000s	Emo
The Taste of Ink	The Used			2000s	Emo
Guns of Summer	Coheed and Cambria			2010s	Progressive
Here We Are Juggernaut	Coheed and Cambria			2010s	Progressive
The Broken	Coheed and Cambria			2010s	Progressive
Peek-a-Boo	Siouxsie and The Banshees			1980s	Pop-Rock
Sun Hits the Sky	Supergrass			1990s	Alternative
American Music	Violent Femmes			1990s	Alternative
Again	Flyleaf			2000s	Alternative
Tomorrow	Silverchair			1990s	Alternative
Thunderbirds Are Go!	Busted			2000s	Pop-Rock
Different People	No Doubt			1990s	Pop-Rock
End It on This	No Doubt			1990s	Pop-Rock
Happy Now?	No Doubt			1990s	Pop-Rock
Hey You	No Doubt			1990s	Pop-Rock
Sixteen	No Doubt			1990s	Pop-Rock
The Climb	No Doubt			1990s	Pop-Rock
Tragic Kingdom	No Doubt			1990s	Pop-Rock
World Go 'Round	No Doubt			1990s	Pop-Rock
You Can Do It	No Doubt			1990s	Pop-Rock
According to You	Orianthi			2000s	Pop-Rock
Dearest (I'm So Sorry)	Picture Me Broken			2010s	Metal
Breaking the Law (Live)	Judas Priest			2010s	Metal
Rapid Fire (Live)	Judas Priest			2010s	Metal
Metal Gods (Live)	Judas Priest			2010s	Metal
Grinder (Live)	Judas Priest			2010s	Metal
United (Live)	Judas Priest			2010s	Metal
Living After Midnight (Live)	Judas Priest			2010s	Metal
You Don't Have to Be Old to Be Wise (Live)	Judas Priest			2010s	Metal
The Rage (Live)	Judas Priest			2010s	Metal
Steeler (Live)	Judas Priest			2010s	Metal
Beat It on Down the Line	Grateful Dead			1960s	Classic Rock
Cumberland Blues	Grateful Dead			1970s	Classic Rock
Scarlet Begonias	Grateful Dead			1970s	Classic Rock
Throwing Stones	Grateful Dead			1980s	Classic Rock
Touch of Grey	Grateful Dead			1980s	Classic Rock
U.S. Blues	Grateful Dead			1970s	Classic Rock
A Girl Like You	The Smithereens			1980s	Rock
Only a Memory	The Smithereens			1980s	Rock
The Great Southern Trendkill	Pantera			1990s	Metal
War Nerve	Pantera			1990s	Metal
Drag the Waters	Pantera			1990s	Metal
10s	Pantera			1990s	Metal
13 Steps to Nowhere	Pantera			1990s	Metal
Suicide Note Pt. II	Pantera			1990s	Metal
Living Through Me (Hell's Wrath)	Pantera			1990s	Metal
Floods	Pantera			1990s	Metal
The Underground in America	Pantera			1990s	Metal
(Reprise) Sandblasted Skin	Pantera			1990s	Metal
Alive	P.O.D.			2000s	Nu-Metal
Trouble Comes Running	Spoon			2010s	Indie Rock
Don't You Evah	Spoon			2000s	Indie Rock
I Turn My Camera On	Spoon			2000s	Indie Rock
Got Nuffin	Spoon			2010s	Indie Rock
Cherry Waves	Deftones			2000s	Rock
Hole in the Earth	Deftones			2000s	Rock
Minerva	Deftones			2000s	Rock
The Great Escape	Boys Like Girls			2000s	Emo
Rock Ready	Crown of Thorns			2000s	Rock
Crazy Babies	Ozzy Osbourne			1980s	Metal
Diggin' Me Down	Ozzy Osbourne			2010s	Metal
I Don't Wanna Stop	Ozzy Osbourne			2000s	Metal
Let Me Hear You Scream	Ozzy Osbourne			2010s	Metal
No More Tears	Ozzy Osbourne			1990s	Metal
Soul Sucker	Ozzy Osbourne			2010s	Metal
Can't Be Tamed	Miley Cyrus			2010s	Pop-Rock
7 Things	Miley Cyrus			2000s	Pop-Rock
Fly on the Wall	Miley Cyrus			2000s	Pop-Rock
See You Again	Miley Cyrus			2000s	Pop-Rock
Start All Over	Miley Cyrus			2000s	Pop-Rock
Burn It to the Ground	Nickelback			2000s	Rock
Figured You Out	Nickelback			2000s	Rock
Never Again	Nickelback			2000s	Rock
Photograph	Nickelback			2000s	Rock
Rockstar	Nickelback			2000s	Rock
This Afternoon	Nickelback			2000s	Rock
Bad Moon Rising	Creedence Clearwater Revival			1960s	Southern Rock
Born on the Bayou	Creedence Clearwater Revival			1960s	Southern Rock
Down on the Corner	Creedence Clearwater Revival			1960s	Southern Rock
Fortunate Son (Original Version)	Creedence Clearwater Revival			1960s	Southern Rock
Green River	Creedence Clearwater Revival			1960s	Southern Rock
I Heard It Through the Grapevine	Creedence Clearwater Revival			1970s	Southern Rock
Lookin' out My Back Door	Creedence Clearwater Revival			1970s	Southern Rock
Proud Mary	Creedence Clearwater Revival			1970s	Southern Rock
Run Through the Jungle	Creedence Clearwater Revival			1970s	Southern Rock
Travelin' Band	Creedence Clearwater Revival			1970s	Southern Rock
Up Around the Bend	Creedence Clearwater Revival			1970s	Southern Rock
Who'll Stop the Rain	Creedence Clearwater Revival			1970s	Southern Rock
Get Out	The Vines			2000s	Rock
He's a Rocker	The Vines			2000s	Rock
Orange Amber	The Vines			2000s	Rock
Outtathaway	The Vines			2000s	Rock
Ride	The Vines			2000s	Rock
Future Perfect Tense	Sweet Billy Pilgrim			2000s	Indie Rock
New Dark Ages	Bad Religion			2000s	Punk
No Control	Bad Religion			1980s	Punk
1969	The Stooges			1960s	Rock
I Wanna Be Your Dog	The Stooges			1960s	Rock
No Fun	The Stooges			1960s	Rock
A Dios le Pido	Juanes			2000s	Pop-Rock
Fíjate Bien	Juanes			2000s	Pop-Rock
Gotas de Agua Dulce	Juanes			2000s	Pop-Rock
La Camisa Negra	Juanes			2000s	Pop-Rock
Mala Gente	Juanes			2000s	Pop-Rock
Yerbatero	Juanes			2010s	Pop-Rock
Nightmare	Avenged Sevenfold			2010s	Metal
Seize the Day	Avenged Sevenfold			2000s	Metal
Scream	Avenged Sevenfold			2000s	Metal
Rapture	Blondie			1980s	New Wave
Jesus Freak	DC Talk			1990s	Alternative
The Perfect Crime # 2	The Decemberists			2000s	Indie Rock
I Only Want You	Eagles of Death Metal			2000s	Rock
Saturday Morning	Eels			2000s	Indie Rock
Love Addict	Family Force 5			2000s	Rock
Sturm & Drang	KMFDM			2000s	Metal
Bulletproof	La Roux			2000s	Pop-Rock
Jesus Built My Hotrod	Ministry			1990s	Metal
Stigmata	Ministry			1980s	Metal
Thieves	Ministry			1980s	Metal
Strange Times	The Black Keys			2000s	Rock
I Got Mine	The Black Keys			2000s	Rock
Your Touch	The Black Keys			2000s	Rock
Animal	Neon Trees			2010s	Pop-Rock
Sins of My Youth	Neon Trees			2010s	Pop-Rock
1983	Neon Trees			2010s	Pop-Rock
Asylum	Disturbed			2010s	Metal
The Animal	Disturbed			2010s	Metal
Another Way to Die	Disturbed			2010s	Metal
Mountain Man	Crash Kings			2000s	Rock
Seasons	The Veer Union			2000s	Rock
Bury Me Alive	We Are The Fallen			2010s	Metal
What Was I Thinkin'	Dierks Bentley			2000s	Country
Hell on the Heart	Eric Church			2000s	Country
Women	Jamey Johnson			2000s	Country
Would You Go With Me	Josh Turner			2000s	Country
Days Go By	Keith Urban			2000s	Country
Lookin' for a Good Time	Lady Antebellum			2000s	Country
Rebound	Laura Bell Bundy			2010s	Country
Fancy	Reba McEntire			1990s	Country
It Happens	Sugarland			2000s	Country
Beautiful	Snoop Dogg			2000s	Urban
Drop It Like It's Hot	Snoop Dogg			2000s	Urban
Ridin' In My Chevy	Snoop Dogg			2000s	Urban
Sensual Seduction	Snoop Dogg			2000s	Urban
Snoop's Upside Ya Head	Snoop Dogg			1990s	Urban
Tha Shiznit	Snoop Dogg			1990s	Urban
That's Tha Homie	Snoop Dogg			2000s	Urban
Who Am I (What's My Name)?	Snoop Dogg			1990s	Urban
Holy Diver	Dio			1980s	Metal
Stand Up and Shout	Dio			1980s	Metal
Nirvana	Juliana Hatfield			1990s	Indie Rock
Irish Blood, English Heart	Morrissey			2000s	Indie Rock
Straight Lines	Silverchair			2000s	Alternative
This Charming Man	The Smiths			1980s	Indie Rock
Writing on the Walls	Underoath			2000s	Emo
Is This Love	Bob Marley and the Wailers			1980s	Other
No Woman, No Cry	Bob Marley and the Wailers			1980s	Other
Could You Be Loved	Bob Marley and the Wailers			1980s	Other
Three Little Birds	Bob Marley and the Wailers			1980s	Other
Buffalo Soldier	Bob Marley and the Wailers			1980s	Other
Stir It Up	Bob Marley and the Wailers			1980s	Other
One Love/People Get Ready	Bob Marley and the Wailers			1980s	Other
I Shot the Sheriff	Bob Marley and the Wailers			1980s	Other
Waiting in Vain	Bob Marley and the Wailers			1980s	Other
Redemption Song	Bob Marley and the Wailers			1980s	Other
Satisfy My Soul	Bob Marley and the Wailers			1980s	Other
Exodus	Bob Marley and the Wailers			1980s	Other
Jamming	Bob Marley and the Wailers			1980s	Other
Among The Living	Anthrax			1980s	Metal
I'm the Man	Anthrax			1980s	Metal
Indians	Anthrax			1980s	Metal
Madhouse (Live)	Anthrax			1980s	Metal
Metal Thrashing Mad (Live)	Anthrax			1980s	Metal
I'm Not Okay (I Promise)	My Chemical Romance			2000s	Emo
Welcome to the Black Parade	My Chemical Romance			2000s	Emo
Closer to the Edge	30 Seconds to Mars			2000s	Emo
Coffin Nails	Atreyu			2000s	Metal
Out of Line	Buckcherry			2000s	Rock
Listen to the Music	The Doobie Brothers			1970s	Classic Rock
Long Train Runnin'	The Doobie Brothers			1970s	Classic Rock
Driver 8	R.E.M.			1980s	Alternative
It's the End of the World as We Know It	R.E.M.			1980s	Alternative
Living Well Is the Best Revenge	R.E.M.			2000s	Alternative
Radio Free Europe	R.E.M.			1980s	Alternative
Stand	R.E.M.			1980s	Alternative
Superman	R.E.M.			1980s	Alternative
These Days	R.E.M.			1980s	Alternative
What's the Frequency, Kenneth?	R.E.M.			1990s	Alternative
Children of the Revolution	T. Rex			1970s	Classic Rock
Cosmic Dancer	T. Rex			1970s	Classic Rock
Jeepster	T. Rex			1970s	Classic Rock
Purple Haze	The Jimi Hendrix Experience			1960s	Classic Rock
Manic Depression	The Jimi Hendrix Experience			1960s	Classic Rock
Hey Joe (Live)	The Jimi Hendrix Experience			1960s	Classic Rock
Love or Confusion	The Jimi Hendrix Experience			1960s	Classic Rock
May This Be Love	The Jimi Hendrix Experience			1960s	Classic Rock
The Wind Cries Mary	The Jimi Hendrix Experience			1960s	Classic Rock
Fire (Live)	Jimi Hendrix			1960s	Classic Rock
3rd Stone from the Sun	The Jimi Hendrix Experience			1960s	Classic Rock
Foxey Lady	The Jimi Hendrix Experience			1960s	Classic Rock
Are You Experienced?	The Jimi Hendrix Experience			1960s	Classic Rock
Stone Free	Jimi Hendrix			2010s	Classic Rock
Highway Chile	The Jimi Hendrix Experience			1960s	Classic Rock
Big Empty	Stone Temple Pilots			1990s	Alternative
Crackerman	Stone Temple Pilots			1990s	Alternative
Creep	Stone Temple Pilots			1990s	Alternative
Dead & Bloated	Stone Temple Pilots			1990s	Alternative
Huckleberry Crumble	Stone Temple Pilots			2010s	Alternative
Trippin' on a Hole in a Paper Heart	Stone Temple Pilots			1990s	Alternative
Bleed American	Jimmy Eat World			2000s	Pop-Rock
My Best Theory	Jimmy Eat World			2000s	Pop-Rock
Pain	Jimmy Eat World			2000s	Pop-Rock
A Jagged Gorgeous Wintera	The Main Drag			2007	Indie Rock
Ace of Spades '08	Motörhead			1980	Metal
Alabama Getaway	The Grateful Dead			1980	Classic Rock
Alex Chilton	The Replacements			1987	Rock
Alive	Pearl Jam			1991	Grunge
Almost Easy	Avenged Sevenfold			2007	Metal
American Woman	The Guess Who			1970	Classic Rock
Aqualung	Jethro Tull			1971	Progressive
Bad Reputation	Joan Jett			1980	Punk
Bodhisattva	Steely Dan			1973	Classic Rock
Carry On Wayward Son	Kansas			1976	Progressive
Chop Suey	System of a Down			2001	Nu-Metal
Colony of Birchmen	Mastodon			2007	Metal
Come Out and Play (Keep 'Em Separated)	The Offspring			1994	Punk
Conventional Lovera	Speck			2007	Pop/Rock
Cool for Cats	Squeeze			1979	New Wave
De-Luxe	Lush			1990	Alternative
Down with the Sickness	Disturbed			2000	Nu-Metal
Drain You	Nirvana			1991	Grunge
E-Pro	Beck			2005	Alternative
Everlong	Foo Fighters			1997	Alternative
Eye of the Tiger	Survivor			1982	Rock
Feel the Pain	Dinosaur Jr.			1994	Alternative
Float On	Modest Mouse			2004	Indie Rock
Get Cleana	Anarchy Club			2008	Metal
Girl's Not Grey	AFI			2003	Alternative
Give It All	Rise Against			2004	Punk
Go Your Own Way	Fleetwood Mac			1976	Classic Rock
Hello There	Cheap Trick			1977	Rock
Hungry Like the Wolf	Duran Duran			1982	Pop/Rock
I Was Wrong	Social Distortion			1996	Punk
Kids in America	The Muffs			1991	Pop/Rock
Lazy Eye	Silversun Pickups			2007	Indie Rock
Livin' on a Prayerc	Bon Jovi			1986	Rock
Lump	Presidents of the United States of America			1995	Pop/Rock
Man in the Box	Alice in Chains			1991	Grunge
Master Exploder	Tenacious D			2006	Rock
Mountain Song	Jane's Addiction			1988	Alternative
My Own Worst Enemy	Lit			1999	Pop/Rock
New Kid in School	The Donnas			2007	Rock
Night Liesa	Bang Camaro			2008	Rock
Nine in the Afternoon	Panic! at the Disco			2008	Pop/Rock
One Step Closer	Linkin Park			2000	Nu-Metal
One Way or Another	Blondie			1979	Pop/Rock
Our Truth	Lacuna Coil			2006	Metal
Painkiller	Judas Priest			1990	Metal
Panic Attack	Dream Theater			2005	Progressive
PDA	Interpol			2002	Indie Rock
Peace Sells	Megadeth			1986	Metal
Pinball Wizard	The Who			1969	Classic Rock
Pretend We're Dead	L7			1992	Grunge
Psycho Killer	Talking Heads			1977	New Wave
Pump It Up	Elvis Costello			1978	Rock
Ramblin' Man	The Allman Brothers Band			1973	Southern Rock
Rebel Girl	Bikini Kill			1993	Punk
Rob the Prez-O-Denta	That Handsome Devil			2008	Rock
Rock'n Me	Steve Miller Band			1976	Classic Rock
Round and Round	Ratt			1984	Metal
Shackler's Revenge	Guns N' Roses			2008	Rock
Shooting Star	Bad Company			1974	Classic Rock
Shoulder to the Plowa	Breaking Wheel			2000s	Metal
So What'cha Want	Beastie Boys			1990s	Rock
Souls of Black	Testament			1990s	Metal
Spirit in the Sky	Norman Greenbaum			1960s	Classic Rock
Supreme Girla	The Sterns			2000s	Pop/Rock
Tangled Up in Blue	Bob Dylan			1974	Classic Rock
Teen Age Riot	Sonic Youth			1988	Alternative
Testify	Rage Against the Machine			1990s	Alternative
That's What You Get	Paramore			2000s	Pop/Rock
The Middle	Jimmy Eat World			2000s	Pop/Rock
The Trees (Vault Edition)	Rush			1978	Progressive
Today	The Smashing Pumpkins			1990s	Alternative
Uncontrollable Urge	Devo			1977-1978	New Wave
Visionsa	Abnormality			2000s	Metal
We Got the Beat	The Go-Go's			1981	Pop/Rock
Welcome to the Neighborhooda	Libyans			2000s	Punk
Where'd You Go?	The Mighty Mighty Bosstones			1990s	Alternative
White Wedding (Part 1)	Billy Idol			1980s	Rock
You Oughta Know	Alanis Morissette			1990s	Pop/Rock
Are You Gonna Be My Girl	Jet			2003	Rock
Ballroom Blitz	Sweet			1973	Glam
Black Hole Sun	Soundgarden			1994	Grunge
Blitzkrieg Bop	Ramones			1976	Punk
Celebrity Skin	Hole			1998	Pop/Rock
Cherub Rock	Smashing Pumpkins			1993	Alternative
Creep	Radiohead			1992	Alternative
Dani California	Red Hot Chili Peppers			2006	Alternative
Dead on Arrival	Fall Out Boy			2003	Pop/Rock
Detroit Rock City	Kiss			1976	Classic Rock
(Don't Fear) The Reaper	Blue Öyster Cult			1976	Classic Rock
Electric Version	The New Pornographers			2003	Indie Rock
Epic	Faith No More			1990	Rock
Flirtin' with Disaster	Molly Hatchet			1979	Southern Rock
Foreplay/Long Time	Boston			1977	Classic Rock
Gimme Shelter	The Rolling Stones			1969	Classic Rock
Go with the Flow	Queens of the Stone Age			2003	Alternative
Green Grass and High Tides	The Outlaws			1975	Southern Rock
Here It Goes Again	OK Go			2006	Pop/Rock
Highway Star	Deep Purple			1972	Classic Rock
I Think I'm Paranoid	Garbage			1998	Alternative
In Bloom	Nirvana			1992	Grunge
Learn to Fly	Foo Fighters			1999	Alternative
Main Offender	The Hives			2001	Punk
Maps	Yeah Yeah Yeahs			2003	Indie Rock
Mississippi Queen	Mountain			1970	Southern Rock
Next to You	The Police			1978	Rock
Orange Crush	R.E.M.			1988	Alternative
Reptilia	The Strokes			2004	Rock
Sabotage	Beastie Boys			1994	Rock
Say It Ain't So	Weezer			1995	Alternative
Should I Stay or Should I Go	The Clash			1982	Punk
Suffragette City	David Bowie			1972	Glam
The Hand That Feeds	Nine Inch Nails			2005	Rock
Tom Sawyer	Rush			1981	Progressive
Train Kept A-Rollin'	Aerosmith			1974	Rock
Vasoline	Stone Temple Pilots			1994	Alternative
Wanted Dead or Alive	Bon Jovi			1987	Rock
Wave of Mutilation	Pixies			1987	Alternative
Welcome Home	Coheed and Cambria			2005	Progressive
When You Were Young	The Killers			2006	Alternative
Won't Get Fooled Again	The Who			1971	Classic Rock
Ain’t Messin ‘Round	Gary Clark, Jr.			2012	Rock
Albert	Eddie Japan			2015	Indie Rock
All Over You	Live			1994	Alternative
Arabella	Arctic Monkeys			2013	Rock
At Night in Dreams	White Denim			2013	Indie Rock
Birth in Reverse	St. Vincent			2014	Indie Rock
Brown Eyed Girl	Van Morrison			1967	R&B/Soul/Funk
Caught Up in You	.38 Special			1982	Southern Rock
Cedarwood Road	U2			2014	Rock
Centuries	Fall Out Boy			2015	Pop-Rock
Cold Clear Light	Johnny Blazes and the Pretty Boys			2015	R&B/Soul/Funk
Dead Black (Heart of Ice)	Soul Remnants			2013	Metal
Dream Genie	Lightning Bolt			2015	Rock
The Feast and the Famine	Foo Fighters			2014	Alternative
Fever	The Black Keys			2014	Rock
Follow You Down	Gin Blossoms			1996	Alternative
Free Falling	The Warning			2015	Rock
Friday I'm In Love	The Cure			1992	New Wave
Hail to the King	Avenged Sevenfold			2013	Metal
Halls of Valhalla	Judas Priest			2014	Metal
I Am Electric	Heaven's Basement			2013	Rock
I Bet My Life	Imagine Dragons			2015	Alternative
I Miss the Misery	Halestorm			2012	Rock
I Will Follow	U2			1980	Rock
The Impression That I Get	The Mighty Mighty Bosstones			1997	Reggae/Ska
Kick It Out	Heart			1977	Classic Rock
Knock Em Down	Duck & Cover			2014	Punk
Lazaretto	Jack White			2014	Rock
Light the Fuse	Slydigs			2015	Rock
Light Up the Night	The Protomen			2009	Rock
Little Miss Can't Be Wrong	Spin Doctors			1991	Alternative
Little White Church	Little Big Town			2010	Country
Mainstream Kid	Brandi Carlile			2015	Blues
Metropolis—Part I: The Miracle and the Sleeper	Dream Theater			1992	Prog
Milwaukee	The Both			2014	Pop-Rock
Miracle Man	Ozzy Osbourne			1988	Metal
My God Is the Sun	Queens of the Stone Age			2013	Alternative
No One Like You (2011 Re-record)	Scorpions			1982	Metal
The One I Love	R.E.M.			1987	Alternative
Panama	Van Halen			1984	Rock
A Passage to Bangkok	Rush			1976	Prog
Pistol Whipped	Tijuana Sweetheart			2012	Punk
Prayer	Disturbed			2002	Nu-Metal
Recession	Jeff Allen ft. Noelle LeBlanc and Naoko Takamoto			2015	Pop/Dance/Electronic
Rock and Roll, Hoochie Koo	Rick Derringer			1973	Classic Rock
The Seeker	The Who			1970	Classic Rock
Short Skirt/Long Jacket	Cake			2001	Alternative
Somebody Told Me	The Killers			2004	Alternative
Spiders	System of a Down			1998	Nu-Metal
Start a Band	Brad Paisley ft. Keith Urban			2008	Country
Still Into You	Paramore			2013	Pop-Rock
Superunknown	Soundgarden			1994	Grunge
Suspicious Minds	Elvis Presley			1969	Rock
That Smell	Lynyrd Skynyrd			1977	Southern Rock
Tongue Tied	Grouplove			2011	Indie Rock
Toys in the Attic	Aerosmith			1975	Rock
Turn it Around	Lucius			2013	Indie Rock
Uptown Funk	Mark Ronson ft. Bruno Mars			2015	R&B/Soul/Funk
V-Bomb	Dark Wheels			2015	Rock
Violent Shiver	Benjamin Booker			2014	Rock
The Warrior	Scandal			1984	Rock
What's Up?	4 Non Blondes			1992	Alternative
The Wolf	Mumford & Sons			2015	Rock
You Make Loving Fun	Fleetwood Mac			1977	Classic Rock
Your Love	The Outfield			1985	Pop-Rock
Happy Song	Bring Me the Horizon			2015	Nu-Metal
Safe and Sound	Capital Cities			2011	Pop/Dance/Electronic
Save Tonight	Eagle-Eye Cherry			1997	Alternative
Sweater Weather	The Neighbourhood			2011	Indie Rock
Little Talks	Of Monsters and Men			2011	Indie Rock
Happy	Pharrell Williams			2013	R&B/Soul/Funk
Closing Time	Semisonic			1998	Alternative
Chandelier	Sia			2014	Pop/Dance/Electronic
Feel Invincible	Skillet			2016	Rock
King of the World	Weezer			2016	Alternative
One More Night	Maroon 5			2012	Pop-Rock
3:00 AM	Matchbox Twenty			1997	Alternative
Bethany	Goddamn Draculas			2015	Rock
Black Corridor	Worshipper			2016	Metal
Black Streak	Nemes			2014	Indie Rock
Closer, Closer	The Warning Shots			2016	Punk
Constant Disaster	When Particles Collide			2014	Alternative
Hour of Rats	The Red Chord			2009	Metal
I Recognize	Newfane			2016	Alternative
Mean Girls	Petty Morals			2016	Pop-Rock
Never Let 'Em Hold Ya Back!	Parlour Bells			2016	Glam
Pain Killer	Ruby Rose Fox			2016	Indie Rock
Shadow	Bearstronaut			2016	Pop-Rock
True Confessional	Party Bois			2016	Pop/Dance/Electronic
S.O.M.P[23]	Skratch'N Snyf			1990	Glam
Sink	Animal Flag			2016	Indie Rock
These Hands	Bent Knee			2016	Indie Rock
No Place for Me	Black Beach			2016	Rock
History Repeats	Creaturos			2016	Rock
RudeBoys	Dutch ReBelle			2016	Hip-Hop/Rap
Hurry Up (& Wait for You)	Julie Rhodes			2016	Indie Rock
Casablanca	Littlefoot			2016	Pop-Rock
Cross That Line	Michael Christmas			2016	Hip-Hop/Rap
Skydiver	Ruby Rose Fox			2016	Indie Rock
Good	STL GLD			2016	Hip-Hop/Rap
Alone Time	Tigerman WOAH			2016	Rock
Sweater Weather	Parks			2012	Pop-Rock
To My Romeo	Spirit Kid			2016	Pop-Rock
Black Seas	Arctic Horror			2016	Metal
(You're) Breakin' Up	The Black Cheers			2015	Punk
Open Water	Assuming We Survive			2016	Rock
Shy	Hunny			2017	Indie Rock
Bloodhands (Oh My Fever)	In the Valley Below			2017	Indie Rock
Who's Your Lover	Nightmare Air			2017	Indie Rock
Radio	No Small Children			2017	Rock
Forget About Tomorrow	The Bergamot			2016	Alternative
I Hear the Dead	Dolly Spartans			2017	Alternative
Body Like That	The Eiffels			2018	Alternative
Vinyl	Fly by Midnight			2018	Pop/Dance/Electronic
Shame	Jocelyn and Chris Arndt			2016	Rock
Survive	The Warning			2017	Rock
This Will Be the Day	Jeff Williams feat. Casey Lee Williams			2013	Rock
Thinking Emoji	Barely March			2018	Punk
Love That Hurts	PREACHERVAN			2018	Alternative
Let's Just Dance	Ships Have Sailed			2018	Alternative
Save Yourself	tiLLie			2017	Alternative
My Own Eyes	Weird Al Yankovic			2014	Novelty
Divide	All That Remains			2014	Metal
What If I Was Nothing	All That Remains			2012	Metal
Gimme Chocolate!!	Babymetal			2014	Metal
Run for Cover	Blitz Kids			2014	Pop-Rock
Throne	Bring Me the Horizon			2015	Nu-Metal
Mona Lisa	Dead Sara			2015	Alternative
The Reflex	Duran Duran			1983	Pop-Rock
September	Earth, Wind & Fire			1978	R&B/Soul/Funk
All the Rage Back Home	Interpol			2014	Indie Rock
Move Over	Janis Joplin			1971	Classic Rock
Jane	Jefferson Starship			1979	Classic Rock
Rebellion (ft. Daron Malakian)	Linkin Park			2014	Nu-Metal
The Mephistopheles of Los Angeles	Marilyn Manson			2015	Metal
High Road	Mastodon			2014	Metal
One Big Holiday	My Morning Jacket			2003	Southern Rock
Would You Still Be There	Of Mice & Men			2014	Nu-Metal
Sugar, You	Oh Honey			2015	Indie Rock
Cowboys from Hell (Live from Monsters in Moscow Festival)	Pantera			1991	Metal
King for a Day (ft. Kellin Quinn)	Pierce the Veil			2012	Emo
Summertime Boy	Seasick Steve			2015	Blues
Backwoods Company	The Wild Feathers			2013	Southern Rock
Don't Wanna Fight	Alabama Shakes			2015	Southern Rock
Failure	Breaking Benjamin			2015	Rock
Trainwreck 1979	Death from Above 1979			2014	Rock
Follow Me Down	The Pretty Reckless			2014	Rock
Cryin'	Aerosmith			1993	Rock
Dude (Looks Like a Lady)	Aerosmith			1987	Rock
Eat the Rich	Aerosmith			1993	Rock
Love in an Elevator	Aerosmith			1989	Rock
Rats in the Cellar	Aerosmith			1976	Rock
Seasons of Wither	Aerosmith			1974	Rock
Always Something There to Remind Me	Naked Eyes			1983	New Wave
People Are People	Depeche Mode			1984	Pop/Dance/Electronic
What You Need	INXS			1985	Pop-Rock
Bad Case of Loving You (Doctor, Doctor)	Robert Palmer			1979	Pop-Rock
Long Cool Woman in a Black Dress	The Hollies			1971	Classic Rock
Lust for Life	Iggy Pop			1977	Rock
Like a Stone	Audioslave			2002	Rock
Awake	Godsmack			2000	Nu-Metal
Lying from You	Linkin Park			2003	Nu-Metal
Bad Catholics 	The Barbazons			2015	Indie Rock
Sing	Ed Sheeran			2014	Pop-Rock
Young Blood 	Saint Raymond			2015	Pop-Rock
Riptide	Vance Joy			2013	Indie Rock
Shut Up and Dance	Walk the Moon			2014	Pop-Rock
And The Cradle Will Rock...	Van Halen			1980	Rock
Ain't Talkin' 'bout Love	Van Halen			1978	Rock
Dance the Night Away	Van Halen			1979	Rock
Hot for Teacher	Van Halen			1984	Rock
Runnin' with the Devil	Van Halen			1979	Rock
Unchained	Van Halen			1981	Rock
Dreams	Beck			2015	Alternative
Electric Love	BØRNS			2015	Pop/Dance/Electronic
Cocoon	Catfish and the Bottlemen			2015	Indie Rock
First	Cold War Kids			2015	Indie Rock
Renegades	X Ambassadors			2015	Alternative
The Coma Machine	Between the Buried and Me			2015	Prog
Heir Apparent	Opeth			2008	Prog
Nevermore	Symphony X			2015	Prog
Ex's and Oh's	Elle King			2015	Alternative
Can't Feel My Face	The Weeknd			2015	Pop/Dance/Electronic
Irresistible	Fall Out Boy			2015	Pop-Rock
Different Colors	Walk the Moon			2015	Pop-Rock
Stitches	Shawn Mendes			2015	Pop-Rock
Sunday Bloody Sunday	U2			1983	Rock
Pride (In the Name of Love)	U2			1984	Rock
Where the Streets Have No Name	U2			1987	Rock
Desire	U2			1988	Rock
One	U2			1991	Rock
Vertigo	U2			2004	Rock
California (There Is No End to Love)	U2			2014	Rock
The Miracle (Of Joey Ramone)	U2			2014	Rock
Adventure of a Lifetime	Coldplay			2015	Alternative
Drag Me Down	One Direction			2015	Pop/Dance/Electronic
Thank God for Girls	Weezer			2015	Alternative
What Do You Mean?	Justin Bieber			2015	Pop/Dance/Electronic
On My Mind	Ellie Goulding			2015	Pop/Dance/Electronic
Leave the Night On	Sam Hunt			2014	Country
Immortalized	Disturbed			2015	Nu-Metal
The Vengeful One	Disturbed			2015	Nu-Metal
Warrior	Disturbed			2010	Nu-Metal
My Wave	Soundgarden			1994	Grunge
Wicked Garden	Stone Temple Pilots			1992	Alternative
Hunger Strike	Temple of the Dog			1991	Grunge
Get Lucky	Daft Punk ft. Pharrell Williams			2013	Pop/Dance/Electronic
Heartbeat Song	Kelly Clarkson			2015	Pop/Dance/Electronic
Hey Ya!	Outkast			2003	Hip-Hop/Rap
Locked Out of Heaven	Bruno Mars			2012	Pop-Rock
Treasure	Bruno Mars			2012	Pop-Rock
Dancing with Myself	Generation X			1981	Punk
Love Stinks	The J. Geils Band			1980	Rock
I Hate Myself for Loving You	Joan Jett & the Blackhearts			1988	Punk
Speed Fighter	Masaya Matsuura			2014	Pop/Dance/Electronic
Still the One	Orleans			1976	Rock
Got Your Six	Five Finger Death Punch			2015	Metal
Thunder & Lightning	Motörhead			2015	Metal
Figure It Out	Royal Blood			2014	Rock
Chicken Fried	Zac Brown Band			2008	Country
Homegrown	Zac Brown Band			2015	Country
The Wind	Zac Brown Band			2012	Country
Best Song Ever	One Direction			2013	Pop/Dance/Electronic
Never Enough	One Direction			2015	Pop/Dance/Electronic
Story of My Life	One Direction			2013	Pop/Dance/Electronic
What Makes You Beautiful	One Direction			2011	Pop/Dance/Electronic
Zombie	The Cranberries			1994	Alternative
Ode to My Family	The Cranberries			1994	Alternative
Dreams	The Cranberries			1993	Alternative
She Looks So Perfect	5 Seconds of Summer			2014	Pop-Rock
My Songs Know What You Did in the Dark (Light Em Up)	Fall Out Boy			2013	Pop-Rock
Everybody Talks	Neon Trees			2012	Pop-Rock
That's My Kind of Night	Luke Bryan			2013	Country
House Party	Sam Hunt			2014	Country
Blown Away	Carrie Underwood			2012	Country
Day Late, Dollar Short	The Acro-Brats			2006	Rock
Blood Doll	Anarchy Club			2007	Rock
Pleasure (Pleasure)	Bang Camaro			2007	Rock
Push Push, Lady Lightning	Bang Camaro			2007	Rock
Lodger	Blanks.			2009	Indie Rock
Shake	Count Zero			2008	Rock
Can't Let Go	Death of the Cool			2007	Rock
The Heist	DnA's Evolution			2009	Rock
Blink	Father Octopus			2010	Rock
Brainpower	Freezepop			2007	Pop/Dance/Electronic
Less Talk More Rokk	Freezepop			2007	Pop/Dance/Electronic
Sprode	Freezepop			2003	Pop/Dance/Electronic
Signs	Giant Target			2009	Punk
I Get By	Honest Bob and the Factory-to-Dealer Incentives			2007	Indie Rock
Don't Let Me Down (Slowly)	The Main Drag			2009	Indie Rock
What's Your Favorite Dinosaur?	The Main Drag			2008	Indie Rock
Synthesized	Symbion Project			2003	Pop/Dance/Electronic
No Mercy	Tijuana Sweetheart			2009	Punk
Seven	Tijuana Sweetheart			2007	Punk
Trash Candy	Tijuana Sweetheart			2009	Punk
Outside	Tribe			1989	Rock
Cake by the Ocean	DNCE			2015	Pop-Rock
Stressed Out[s]	Twenty One Pilots			2015	Alternative
The Hills	The Weeknd			2015	Pop/Dance/Electronic
Sorry	Justin Bieber			2015	Pop/Dance/Electronic
Boyfriend	Justin Bieber			2012	Pop/Dance/Electronic
Love Yourself	Justin Bieber			2015	Pop/Dance/Electronic
Redneck	Lamb of God			2006	Metal
What I Like About You	The Romantics			1980	Pop-Rock
Dope Nose	Weezer			2002	Alternative
Don't Do Me Like That	Tom Petty and the Heartbreakers			1979	Rock
Learning to Fly	Tom Petty and the Heartbreakers			1991	Rock
Breakfast at Tiffany's	Deep Blue Something			1995	Alternative
Take Me to Church	Hozier			2014	Indie Rock
Hey Jealousy	Gin Blossoms			1993	Alternative
Found Out About You	Gin Blossoms			1993	Alternative
We're Not Gonna Take It	Twisted Sister			1984	Glam
Cherry Pie	Warrant			1990	Metal
Hook	Blues Traveler			1994	Rock
Famous Last Words	My Chemical Romance			2006	Emo
Rude	Magic!			2014	Pop-Rock
Iris	Goo Goo Dolls			1998	Alternative
Radioactive	Imagine Dragons			2012	Alternative
Never Too Late	Three Days Grace			2006	Rock
Africa	Toto			1982	Pop-Rock
All These Things That I've Done	The Killers			2004	Alternative
Lips of an Angel	Hinder			2005	Rock
Where Is My Mind?	Pixies			1988	Alternative
Rock This Town	Brian Setzer			2007	Rock
Jumper	Third Eye Blind			1997	Alternative
Uptown Girl	Billy Joel			1983	Classic Rock
Hemorrhage (In My Hands)	Fuel			2000	Rock
Pompeii	Bastille			2013	Indie Rock
I Gotta Feeling	The Black Eyed Peas			2009	Pop/Dance/Electronic
Blurred Lines	Robin Thicke ft. Pharrell			2013	R&B/Soul/Funk
Mr. Jones	Counting Crows			1993	Alternative
Heaven Is a Place on Earth	Belinda Carlisle			1987	Pop-Rock
Bad Catholics	The Barbazons			2015	Indie Rock
If You Could Only See	Tonic			1996	Alternative
Everything You Want	Vertical Horizon			1999	Alternative
I'm Yours	Jason Mraz			2008	Pop-Rock
Starships	Nicki Minaj			2012	Pop/Dance/Electronic
What About Love	Heart			1985	Classic Rock
Seventeen	Winger			1988	Glam
Wrong Side of Heaven	Five Finger Death Punch			2013	Metal
Lifestyles of the Rich and Famous	Good Charlotte			2002	Punk
Dirt Road Anthem	Jason Aldean			2010	Country
All for You	Sister Hazel			1997	Alternative
Dystopia	Megadeth			2016	Metal
Road to Nowhere	Ozzy Osbourne			1991	Metal
The Devil in I	Slipknot			2014	Nu-Metal
HandClap	Fitz and the Tantrums			2016	Pop-Rock
The Sound of Silence	Disturbed			2015	Nu-Metal
Flagpole Sitta	Harvey Danger			1997	Alternative
Stop	Jane's Addiction			1990	Alternative
Honey, I'm Good.	Andy Grammer			2014	Pop-Rock
Treat You Better	Shawn Mendes			2016	Pop-Rock
Closer	The Chainsmokers ft. Halsey			2016	Pop/Dance/Electronic
Cheap Thrills	Sia ft. Sean Paul			2016	Pop/Dance/Electronic
Hold My Hand	Hootie & the Blowfish			1994	Alternative
Only Wanna Be with You	Hootie & the Blowfish			1994	Alternative
Let Her Cry	Hootie & the Blowfish			1994	Alternative
Born Again Tomorrow	Bon Jovi			2016	Rock
Lovesong	The Cure			1989	New Wave
Time After Time	Cyndi Lauper			1983	Pop-Rock
She Drives Me Crazy	Fine Young Cannibals			1989	New Wave
Complicated	Avril Lavigne			2002	Pop-Rock
My Happy Ending	Avril Lavigne			2004	Pop-Rock
What the Hell	Avril Lavigne			2011	Pop-Rock
24K Magic	Bruno Mars			2016	Pop-Rock
Hymn for the Weekend	Coldplay			2016	Alternative
Still Breathing	Green Day			2016	Rock
Starboy	The Weeknd ft. Daft Punk			2016	Pop/Dance/Electronic
Waste a Moment	Kings of Leon			2016	Rock
Chop Suey!	System of a Down			2001	Nu-Metal
Heathens	Twenty One Pilots			2016	Alternative
Ride	Twenty One Pilots			2015	Alternative
Royals	Lorde			2013	Pop/Dance/Electronic
All About That Bass	Meghan Trainor			2014	Pop/Dance/Electronic
The Greatest	Sia ft. Kendrick Lamar			2016	Pop/Dance/Electronic
Angel	Aerosmith			1987	Rock
Crazy	Aerosmith			1993	Rock
I Don't Want to Miss a Thing	Aerosmith			1998	Rock
Janie's Got a Gun	Aerosmith			1989	Rock
Livin' on the Edge	Aerosmith			1993	Rock
Rag Doll	Aerosmith			1987	Rock
Wake Me Up	Avicii			2013	Pop/Dance/Electronic
Celebration	Kool & the Gang			1980	R&B/Soul/Funk
Party Rock Anthem	LMFAO ft. Lauren Bennett & GoonRock			2011	Pop/Dance/Electronic
The Stage	Avenged Sevenfold			2016	Metal
Trust	Megadeth			1997	Metal
Dead Memories	Slipknot			2008	Nu-Metal
Swing, Swing	The All-American Rejects			2003	Emo
Some Nights	fun.			2012	Pop-Rock
Cheerleader (Felix Jaehn Remix)	OMI			2015	Pop/Dance/Electronic
Hold the Line	Toto			1978	Pop-Rock
S.O.M.P.	Skratch'N Snyf			1990	Glam
Applause	Lady Gaga			2013	Pop/Dance/Electronic
A-YO	Lady Gaga			2016	Pop/Dance/Electronic
The Edge of Glory	Lady Gaga			2011	Pop/Dance/Electronic
I Wanna Rock	Twisted Sister			1984	Glam
I Will Survive	Cake			1996	Alternative
Want to Want Me	Jason Derulo			2015	Pop/Dance/Electronic
Don't You (Forget About Me)	Simple Minds			1985	New Wave
In Too Deep	Sum 41			2001	Punk
Black Betty	Ram Jam			1977	Classic Rock
Outside	Staind			2001	Nu-Metal
Can't Hold Us	Macklemore & Ryan Lewis ft. Ray Dalton			2012	Hip-Hop/Rap
Danger Zone	Kenny Loggins			1986	Pop-Rock
Use Somebody	Kings of Leon			2008	Rock
I Will Wait	Mumford & Sons			2012	Rock
Counting Stars	OneRepublic			2013	Pop-Rock
Promise Everything	Basement			2016	Alternative
Shape of You	Ed Sheeran			2017	Pop-Rock
You Make My Dreams	Hall & Oates			1980	Pop-Rock
Glass House	Kaleo			2016	Rock
Bizarre Love Triangle	New Order			1986	New Wave
Champagne Supernova	Oasis			1995	Rock
Heaven Knows	The Pretty Reckless			2014	Rock
This Is How We Do It	Montell Jordan			1995	Hip-Hop/Rap
Kids	MGMT			2007	Pop/Dance/Electronic
Mother Mother	Tracy Bonham			1996	Alternative
Shout	The Isley Brothers			1959	R&B/Soul/Funk
Bored to Death	Blink-182			2016	Punk
You & Me	The Hunna			2016	Indie Rock
Pull Me Under	Dream Theater			1992	Prog
Circles	Pierce the Veil			2016	Emo
Killing Is Just a Means 	Permaband			2014	Rock
Wrecking Machine 	Permaband			2016	Rock
Girls Just Want to Have Fun	Cyndi Lauper			1983	Pop-Rock
Ain't It Fun	Paramore			2013	Pop-Rock
Freewill (Vault Edition)	Rush			1980	Prog
Cirice	Ghost			2015	Metal
In-A-Gadda-Da-Vida	Iron Butterfly			1968	Classic Rock
She	Legitimate Front			2012	R&B/Soul/Funk
Gold on the Ceiling	The Black Keys			2011	Rock
Hold On	Wilson Phillips			1990	Pop-Rock
Alive	The Temper Trap			2016	Indie Rock
True Confessions	Blondfire			2016	Indie Rock
Rebel Heart	The Shelters			2016	Rock
Stupid Girl	Garbage			1995	Alternative
Every Morning	Sugar Ray			1999	Alternative
Postpone	Catfish and the Bottlemen			2016	Indie Rock
Stranglehold	Ted Nugent			1975	Classic Rock
Ice Ice Baby	Vanilla Ice			1990	Hip-Hop/Rap
I Wanna Dance with Somebody (Who Loves Me)	Whitney Houston			1987	Pop/Dance/Electronic
God Damn	Avenged Sevenfold			2016	Metal
Super Freak	Rick James			1981	R&B/Soul/Funk
Float	Switchfoot			2016	Alternative
Burnin' for You	Blue Öyster Cult			1981	Classic Rock
There's Nothing Holdin' Me Back	Shawn Mendes			2016	Pop-Rock
Heat of the Moment	Asia			1982	Classic Rock
Down in a Hole	Alice in Chains			1992	Grunge
Them Bones	Alice in Chains			1992	Grunge
Johnny B. Goode	Chuck Berry			1959	Classic Rock
I Want You Back	The Jackson 5			1969	Pop-Rock
Slow Ride	Foghat			1975	Classic Rock
Play That Funky Music	Wild Cherry			1976	R&B/Soul/Funk
Super Beat Sports Big Baos Battle	Steve Pardo			2017	Novelty
Blister in the Sun	Violent Femmes			1983	Punk
The Sign	Ace of Base			1993	Pop/Dance/Electronic
Karma Police	Radiohead			1997	Alternative
Hair Trigger	The Acro-Brats			2010	Punk
Collide	Anarchy Club			2007	Metal
Blood Red Rock	Bang Camaro			2008	Rock
Shadowbang (Head)	Bang on a Can All-Stars			2003	Other
Thug Love	Dance for the Dying			2011	Pop-Rock
Doppelgänger	Freezepop			2010	Pop/Dance/Electronic
Cheat on the Church	Graveyard BBQ			2005	Metal
Soy Bomb	Honest Bob and the Factory-to-Dealer Incentives			2008	Indie Rock
How We'd Look On Paper	The Main Drag			2007	Indie Rock
Exploited & Exposed	Symbion Project			2010	Pop/Dance/Electronic
Save a Horse (Ride a Cowboy)	Big & Rich			2004	Country
Twilight of the Thunder God	Amon Amarth			2008	Metal
Run	Foo Fighters			2017	Alternative
Song #3	Stone Sour			2017	Metal
The Way You Used to Do	Queens of the Stone Age			2017	Alternative
Attention	Charlie Puth			2018	Pop-Rock
Sorry Not Sorry	Demi Lovato			2017	Pop/Dance/Electronic
Thunder	Imagine Dragons			2017	Alternative
Feel It Still	Portugal. The Man			2017	Alternative
18 and Life	Skid Row			1989	Glam
Come On Eileen	Dexys Midnight Runners			1982	New Wave
Hooked on a Feeling	Blue Swede			1974	Classic Rock
The Final Countdown	Europe			1986	Glam
Enjoy the Silence	Depeche Mode			1990	Pop/Dance/Electronic
Torn	Natalie Imbruglia			1997	Pop-Rock
I Remember You	Skid Row			1989	Glam
Burnin' It Down	Jason Aldean			2014	Country
Body Like a Back Road	Sam Hunt			2017	Country
That Don't Impress Me Much	Shania Twain			1997	Country
Lonely Is the Night	Billy Squier			1981	Classic Rock
Takin' Care of Business	Bachman–Turner Overdrive			1974	Classic Rock
A Sky Full of Stars	Coldplay			2014	Alternative
Live in the Moment	Portugal. The Man			2017	Alternative
Absolutely (Story of a Girl)	Nine Days			2000	Alternative
Brick House	Commodores			1977	R&B/Soul/Funk
Slide	Goo Goo Dolls			1998	Alternative
Unwell	Matchbox Twenty			2002	Alternative
I Don't Want to Be	Gavin DeGraw			2003	Pop-Rock
Broken	Seether ft. Amy Lee			2004	Rock
Believer	Imagine Dragons			2017	Alternative
Two Princes	Spin Doctors			1993	Alternative
All You Wanted	Michelle Branch			2001	Alternative
Unwritten	Natasha Bedingfield			2004	Pop-Rock
Bad Company	Bad Company			1974	Classic Rock
Roll to Me	Del Amitri			1995	Alternative
Is She Really Going Out with Him?	Joe Jackson			1978	Classic Rock
Cumbersome	Seven Mary Three			1995	Alternative
Stolen Dance	Milky Chance			2013	Alternative
I Want You	Savage Garden			1997	Pop-Rock
Run-Around	Blues Traveler			1994	Rock
Steal My Sunshine	Len			1999	Alternative
Torn in Two	Breaking Benjamin			2018	Rock
The Heart from Your Hate	Trivium			2017	Metal
Karma Chameleon	Culture Club			1983	New Wave
Pictures of Matchstick Men	Status Quo			1968	Classic Rock
We Are Family	Sister Sledge			1979	R&B/Soul/Funk
Right Here, Right Now	Jesus Jones			1991	Alternative
Shame	Jocelyn & Chris Arndt			2016	Rock
Bodies	Drowning Pool			2001	Rock
Higher	Creed			1999	Rock
Going Under	Evanescence			2003	Nu-Metal
If It Means a Lot to You	A Day to Remember			2009	Rock
A Prophecy	Asking Alexandria			2009	Metal
Country Song	Seether			2011	Rock
Airbrushed	Anamanaguchi			2010	Pop/Dance/Electronic
Code Monkey	Jonathan Coulton			2006	Pop-Rock
Hey Baby, Here's That Song You Wanted	Blessthefall			2009	Rock
Relentless Chaos	Miss May I			2010	Metal
Drunken Lullabies (Live)	Flogging Molly			2010	Alternative
Bullet with a Name	Nonpoint			2005	Rock
Reminiscing	Little River Band			1978	Classic Rock
Brandy (You're a Fine Girl)	Looking Glass			1972	Classic Rock
Baby Come Back	Player			1977	Classic Rock
Burn It Down	Five Finger Death Punch			2009	Metal
Hard to See	Five Finger Death Punch			2009	Metal
All I Want	A Day to Remember			2010	Punk
I'm Made of Wax, Larry, What Are You Made Of?	A Day to Remember			2009	Punk
Fake It	Seether			2007	Rock
Rise Above This	Seether			2007	Rock
Rescue Me	30 Seconds to Mars			2018	Rock
Kamikaze	Walk the Moon			2017	Pop-Rock
Give Yourself a Try	The 1975			2018	Alternative
Youngblood	5 Seconds of Summer			2018	Pop-Rock
This Will Be the Day	Jeff Williams ft. Casey Lee Williams			2013	Rock
The Touch	Stan Bush			2007	Rock
Pac-Man Fever	Buckner & Garcia			1999	Novelty
Tastes Like Kevin Bacon	iwrestledabearonce			2009	Metal
BEER!!	Psychostick			2003	Metal
Broken	lovelytheband			2017	Alternative
Sober Up	AJR ft. Rivers Cuomo			2017	Pop-Rock
River of Tuoni	Amberian Dawn			2006	Metal
Knifeman	The Bronx			2008	Punk
American Dream	Silverstein			2009	Rock
Escape (The Piña Colada Song)	Rupert Holmes			1979	Pop-Rock
Red Red Wine	UB40			1983	Reggae/Ska
Pictures of Girls	Wallows			2018	Alternative
Simplify	Young the Giant			2018	Alternative
Dogs Can Grow Beards All Over	The Devil Wears Prada			2006	Metal
HTML Rulez D00d	The Devil Wears Prada			2007	Metal
Jamie All Over	Mayday Parade			2009	Rock
When I Get Home You're So Dead	Mayday Parade			2009	Rock
Unheavenly Creatures	Coheed and Cambria			2018	Prog
When the Curtain Falls	Greta Van Fleet			2018	Rock
Business Time	Flight of the Conchords			2008	Novelty
The Most Beautiful Girl (In the Room)	Flight of the Conchords			2008	Novelty
Graffiti	Chvrches			2018	Alternative
Uncomfortable	Halestorm			2018	Rock
Back to Me	Of Mice & Men			2018	Metal
Second & Sebring	Of Mice & Men			2010	Metal
Those in Glass Houses	Of Mice & Men			2010	Metal
Three Lives	Octavision			2016	Prog
My Demons	Starset			2014	Rock
Paralyzer	Finger Eleven			2007	Alternative
Australia	The Shins			2007	Indie Rock
Little Black Backpack '09	Stroke 9			2010	Rock
Time to Say Goodbye	Jeff Williams ft. Casey Lee Williams			2014	Rock
Is There a Ghost	Band of Horses			2007	Indie Rock
No One's Gonna Love You	Band of Horses			2007	Indie Rock
The Funeral	Band of Horses			2006	Indie Rock
Natural	Imagine Dragons			2018	Alternative
Girls Like You	Maroon 5			2017	Pop-Rock
Crazy on You	Heart			1976	Classic Rock
Magic Man	Heart			1976	Classic Rock
Lose It	Kane Brown			2018	Country
Hotel Key	Old Dominion			2017	Country
Never Let You Go '09	Third Eye Blind			2009	Alternative
Semi Charmed Life '09	Third Eye Blind			2009	Alternative
99	Barns Courtney			2018	Alternative
Music Is Worth Living For	Andrew W.K.			2018	Rock
Angel of Death	Slayer			1986	Metal
Starlight	BABYMETAL			2018	Metal
When Legends Rise	Godsmack			2018	Nu-Metal
Forever in Your Hands	All That Remains			2008	Metal
Hey There Mr. Brooks	Asking Alexandria			2009	Metal
Remedy	Seether			2005	Metal
Shame	Elle King			2018	Alternative
Body Talks	The Struts			2018	Rock
Gasoline	The Bouncing Souls			2010	Alternative
The Triumph	Jeff Williams ft. Casey Lee Williams			2018	Rock
Lady in a Blue Dress	Senses Fail			2004	Alternative
Push	Matchbox Twenty			1996	Alternative
The Reason	Hoobastank			2004	Alternative
Wagon Wheel	Darius Rucker			2013	Country
Bitch	Meredith Brooks			1997	Alternative
Farewell, Mona Lisa	The Dillinger Escape Plan			2010	Metal
Bleed	Meshuggah			2008	Metal
[&] Delinquents	Woe, Is Me			2010	Rock
Drown	Bring Me the Horizon			2015	Nu-Metal
MANTRA	Bring Me the Horizon			2019	Nu-Metal
Pray for Plagues	Bring Me the Horizon			2006	Nu-Metal
Paradise	Coldplay			2011	Alternative
Uma Thurman	Fall Out Boy			2014	Pop-Rock
Superposition	Young the Giant			2018	Alternative
When the Seasons Change	Five Finger Death Punch			2018	Metal
Lemon Meringue Tie	Dance Gavin Dance			2007	Indie Rock
Caraphernelia	Pierce the Veil			2010	Emo
Battle Royale	The Word Alive			2009	Metal
S.O.S.	The Glorious Sons			2017	Rock
Do Your Worst	Rival Sons			2019	Rock
If You Can't Hang	Sleeping With Sirens			2011	Emo
The Attitude Song	Steve Vai			1984	Rock
Seven	Sunny Day Real Estate			1994	Alternative
I'm Gonna Be (500 Miles)	The Proclaimers			1988	Rock
La Bamba	Los Lobos			1987	Pop-Rock
Do Not Disturb	Halestorm			2018	Rock
Flag in the Ground	Sonata Arctica			2009	Metal
Disengage	Suicide Silence			2009	Metal
Hold On	All That Remains			2010	Metal
The Gun Show	In This Moment			2010	Metal
Harmony Hall	Vampire Weekend			2019	Indie Rock
It's Complicated	A Day to Remember			2010	Punk
Longshot	Catfish and the Bottlemen			2019	Indie Rock
Nemesis	Arch Enemy			2005	Metal
Over My Head	Judah & the Lion			2019	Alternative
Night on Bald Mountain (Mussorgsky)	Paul Henry Smith & The Fauxharmonic Orchestra			2010	Classical
The Serpentine Offering	Dimmu Borgir			2007	Metal
Salvation	The Strumbellas			2019	Alternative
You Only Live Once	Suicide Silence			2011	Metal
Tourniquet	Breaking Benjamin			2018	Alternative
The Waiting One	All That Remains			2010	Metal
When Am I Gonna Lose You	Local Natives			2019	Alternative
Wake Up	Suicide Silence			2009	Metal
The Difference Between Medicine and Poison is in the Dose	Circa Survive			2007	Alternative
If I'm James Dean, You're Audrey Hepburn	Sleeping With Sirens			2010	Emo
Berzerker	After the Burial			2009	Metal
We Are Not Anonymous	Unearth			2008	Metal
Shallow Waters	Amberian Dawn			2009	Metal
Lexington (Joey Pea-Pot With a Monkey Face)	Chiodos			2007	Emo
Sucker	Jonas Brothers			2019	Pop-Rock
High Hopes	Panic! at the Disco			2018	Emo
Days Without	All That Remains			2008	Metal
Change	The Revivalists			2018	Alternative
Kick Some Ass '09	Stroke 9			2010	Rock
100 Bad Days	AJR			2019	Pop-Rock
Caves	Chiodos			2010	Emo
Requiem for a Dying Song	Flogging Molly			2008	Punk
For We Are Many	All That Remains			2010	Metal
Obfuscation	Between the Buried and Me			2009	Prog
Alligator	Of Monsters and Men			2019	Indie Rock
The Plot to Bomb the Panhandle	A Day to Remember			2007	Punk
The Final Episode (Let's Change the Channel)	Asking Alexandria			2009	Metal
Blame It on My Youth	Blink-182			2019	Punk
Undone	All That Remains			2008	Metal
Very Busy People	The Limousines			2010	Alternative
Gloria	The Lumineers			2019	Indie Rock
Have Faith in Me	A Day to Remember			2009	Punk
Hurt	Oliver Tree			2019	Alternative
Jumpers	Sleater-Kinney			2005	Indie Rock
Battles and Brotherhood	3 Inches of Blood			2009	Metal
Missed Connection	The Head and the Heart			2019	Alternative
The Hounds of Anubis	The Word Alive			2010	Metal
Robots May Break Your Heart	Riverboat Gamblers			2008	Punk
Entertain	Sleater-Kinney			2005	Indie Rock
Old Town Road (Remix)	Lil Nas X ft. Billy Ray Cyrus			2019	Country
21	H.E.R.			2019	R&B/Soul/Funk
Buster Voodoo	Rodrigo y Gabriela			2009	Rock
sugar honey ice & tea	Bring Me the Horizon			2019	Nu-Metal
When I'm Gone	Dirty Honey			2019	Rock
Highway to Oblivion	DragonForce			2019	Metal
For the Love of God (Live)	Steve Vai			2009	Rock
The Mob Goes Wild	Clutch			2004	Rock
This City Made Us	The Protomen			2015	Rock
Two Shots	Duck & Cover			2019	Punk
Don't Let Her Go	Newfane			2019	Alternative
Time for Crime	ORION			2019	Pop/Dance/Electronic
Fall Apart	Shocked Laura			2019	Pop/Dance/Electronic
Blue on Black	Five Finger Death Punch			2018	Metal
Trouble	Five Finger Death Punch			2017	Metal
You're Gonna Say Yeah!	Hushpuppies			2005	Rock
Might Be Right	White Reaper			2019	Alternative
Feed My Frankenstein	Alice Cooper			1991	Rock
Unsainted	Slipknot			2019	Nu-Metal
CHAMPION	Bishop Briggs			2019	Alternative
Good Things Fall Apart	Illenium & Jon Bellion			2019	Pop/Dance/Electronic
Sequestered in Memphis	The Hold Steady			2008	Indie Rock
You're A Wolf	Sea Wolf			2007	Indie Rock
Dear Insanity	Asking Alexandria			2011	Metal
Morte et Dabo	Asking Alexandria			2011	Metal
Back Foot	Dinosaur Pile-Up			2019	Rock
Welcome Home	Hellyeah			2019	Rock
Taste of Regret	Of Mice & Men			2019	Metal
Prom Queen	Beach Bunny			2018	Alternative
Panic Attack	The Glorious Sons			2019	Rock
16	Highly Suspect			2019	Alternative
Crush	Dave Matthews Band			1998	Rock
Blind Leading the Blind	Mumford & Sons			2019	Rock
One Kind of Solomon	The New Pornographers			2019	Alternative
bad guy	Billie Eilish			2019	Pop/Dance/Electronic
Orphans	Coldplay			2019	Alternative
Take What You Want	Post Malone ft. Ozzy Osbourne & Travis Scott			2019	Pop-Rock
Father of All...	Green Day			2020	Alternative
The End of the Game	Weezer			2020	Alternative
Young Bloods	The Bronx			2008	Punk
I Just Wanna Shine	Fitz and the Tantrums			2019	Pop-Rock
All the Way (Stay)	Jimmy Eat World			2019	Alternative
Chelsea	The Summer Set			2009	Pop-Rock
Circles	Post Malone			2019	Pop-Rock
Can You Tell	Ra Ra Riot			2008	Indie Rock
Addicted	Simple Plan			2002	Alternative
Welcome to My Life	Simple Plan			2004	Alternative
Where I Belong	Simple Plan & State Champs feat. We the Kings			2019	Alternative
No More Mr. Nice Guy	Alice Cooper			1973	Rock
Mechanical Love	In This Moment			2008	Metal
50,000 Unstoppable Watts	Clutch			2009	Rock
Hanuman	Rodrigo y Gabriela			2009	Rock
Inside Out	Five Finger Death Punch			2020	Metal
Novocaine	The Unlikely Candidates			2019	Alternative
Sticks & Bricks	A Day to Remember			2010	Punk
5678	Fake Problems			2010	Alternative
Mordecai	Between the Buried and Me			2003	Prog
Icarus Lives	Periphery			2010	Metal
The Best	AWOLNATION			2019	Alternative
Colors	Black Pumas			2019	Alternative
Some Kind of Disaster	All Time Low			2020	Emo
Better Off This Way	A Day to Remember			2010	Punk
Abigail	Motionless in White			2010	Metal
Approach the Podium	Winds of Plague			2009	Metal
Don't Start Now	Dua Lipa			2019	Pop/Dance/Electronic
Simmer	Hayley Williams			2020	Alternative
Boy	Ra Ra Riot			2010	Indie Rock
One Man Band	Old Dominion			2019	Country
Juice	Lizzo			2019	Pop/Dance/Electronic
Bad Decisions	The Strokes			2020	Rock
Alive and Kicking	Nonpoint			2005	Rock
Born to Be Wild	Steppenwolf			1968	Classic Rock
Rolling 7s	Dirty Honey			2019	Rock
Special Effects	Freezepop			2010	Pop/Dance/Electronic
Reckless & Relentless	Asking Alexandria			2011	Metal
Arcaedion	Children of Nova			2009	Prog
Glycerine	Bush			1994	Grunge
With Arms Wide Open	Creed			1999	Rock
Be Careful What You Wish For	Memphis May Fire			2010	Metal
Hook, Line and Sinner	Texas in July			2009	Metal
Far Away	Breaking Benjamin ft. Scooter Ward of COLD			2020	Rock
Level of Concern	Twenty One Pilots			2020	Alternative
Where Were You?	Every Avenue			2008	Alternative
Falling	Trevor Daniel			2020	Pop/Dance/Electronic
I Think We're Alone Now	Billie Joe Armstrong			2020	Alternative
Van Horn	Saint Motel			2019	Indie Rock
Dark Horse	Converge			2009	Metal
Popular Monster	Falling In Reverse			2019	Rock
10,000 Hours	Dan + Shay & Justin Bieber			2019	Country
Used To Like	Neon Trees			2019	Alternative
Bang!	AJR			2020	Pop-Rock
Incubus	Amberian Dawn			2009	Metal
Adore You	Harry Styles			2019	Pop/Dance/Electronic
Wars	Of Monsters and Men			2019	Indie Rock
Learn to Live	Architects			2011	Metal
Killing Me Slowly	Bad Wolves			2019	Rock
Ikea	Jonathan Coulton			2003	Rock
This is Not a Song, It's a Sandwich!	Psychostick			2009	Metal
Shiver	Coldplay			2000	Alternative
Speed of Sound	Coldplay			2005	Alternative
Champion of the World	Coldplay			2019	Alternative
Something Just Like This	The Chainsmokers & Coldplay			2017	Pop/Dance/Electronic
Buttersnips	Periphery			2010	Metal
Burning Hearts	Silverstein			2011	Rock
Cradles	Sub Urban			2019	Pop/Dance/Electronic
Blinding Lights	The Weeknd			2019	Pop/Dance/Electronic
We Are the One	Anti-Flag			2009	Punk
History of Violence	Theory of a Deadman			2019	Rock
Antisocialist	Asking Alexandria			2020	Metal
Deathbed Atheist	Norma Jean			2010	Metal
Monsters	All Time Low ft. Blackbear			2020	Emo
Flightless Bird, American Mouth	Iron & Wine			2007	Indie Rock
I Know What I Am	Band of Skulls			2009	Indie Rock
I Hope	Gabby Barrett			2020	Country
Angels & Demons	Jxdn			2020	Alternative
Stand for Something	Skindred			2009	Metal
Some1Else	Blame It On Whitman			2020	Punk
Run With You	Radio Compass			2020	Indie Rock
Masquerader	Ravi Shavi			2020	Indie Rock
Stevie Sees	Toad and the Stooligans			2020	Hip-Hop/Rap
Any Other Heart	Go Radio			2011	Pop-Rock
Teenage Dirtbag (2020)	Wheatus			2020	Pop-Rock
Fate of the Maiden	Amberian Dawn			2008	Metal
Selkies: The Endless Obsession	Between the Buried and Me			2005	Metal
A Little Bit Off	Five Finger Death Punch			2020	Metal
The Devil Went Down to Georgia	Nickelback			2020	Rock
CITY OF ANGELS	24kGoldn			2019	Hip-Hop/Rap
Spin	We the Kings			2009	Alternative
White Knuckles	OK Go			2010	Alternative
Caution	The Killers			2020	Alternative
Alive With The Glory Of Love	Say Anything			2004	Emo
Cute Without The 'E' (Cut From the Team)	Taking Back Sunday			2002	Emo
Shot in the Dark	AC/DC			2020	Rock
Death by Rock and Roll	The Pretty Reckless			2020	Rock
Come & Go	Juice WRLD & Marshmello			2020	Hip-Hop/Rap
Rollin' (Air Raid Vehicle)	Limp Bizkit			2000	Nu-Metal
Rebel Rebel	David Bowie			1974	Rock
My Way, Soon	Greta Van Fleet			2020	Rock
Stacy's Mom	Fountains of Wayne			2003	Pop-Rock
Prisoner	Dance Gavin Dance			2020	Indie Rock
Come and Get Your Love	Redbone			1974	R&B/Soul/Funk
Golden	Harry Styles			2019	Pop-Rock
Higher	Shawn Mendes			2020	Pop/Dance/Electronic
stupid horse	100 gecs				
Hey, Hey, Helen	ABBA				
Barbie Girl	Aqua				
Megitsune	BABYMETAL				
Loser	Beck				
Hound Dog	Big Mama Thornton				
you should see me in a crown	Billie Eilish				
Red Flag	Billy Talent				
Ludens	Bring Me the Horizon				
Born to Run	Bruce Springsteen				
There's No Penguins In Alaska	Chiodos				
Long As I Can See The Light	Creedence Clearwater Revival				
Open Your Heart	Crush 40				
Lose Yourself To Dance (ft. Pharrell Williams)	Daft Punk				
Dream House	Deafheaven				
Suburban Home	Descendents				
Hatredcopter	Dethklok				
9 to 5	Dolly Parton				
Hot Stuff	Donna Summer				
Rocket Man	Elton John				
Rock Me Amadeus	Falco				
White Winter Hymnal	Fleet Foxes				
The Chain	Fleetwood Mac				
Never Catch Me (ft. Kendrick Lamar)	Flying Lotus				
Remember the Name (ft. Styles of Beyond)	Fort Minor				
Worlds Away	From First to Last				
Destiny	Galneryus				
I Will Survive	Gloria Gaynor				
Bulletproof	Godsmack				
Dance Floor Anthem	Good Charlotte				
King For A Day	Green Day				
Hollaback Girl	Gwen Stefani				
Love Bites (So Do I)	Halestorm				
Obstacle 1	Interpol				
New Sensation	INXS				
I Feel Fantastic	Jonathan Coulton				
Automation	King Gizzard & the Lizard Wizard				
Alejandro	Lady Gaga				
Break Stuff	Limp Bizkit				
Faint	Linkin Park				
Our House	Madness				
Ain't No Mountain High Enough	Marvin Gaye & Tammi Terrell				
Monsters	Matchbook Romance				
Ardour (Feat. Pauline Murray)	Maxïmo Park				
Bat Out of Hell	Meat Loaf				
Master of Puppets	Metallica				
Shake It	Metro Station				
Conga!	Miami Sound Machine				
Maniac	Michael Sembello				
Beds Are Burning	Midnight Oil				
Mental Hopscotch	Missing Persons				
Stockholm Syndrome	Muse				
The End:Dead!	My Chemical Romance				
99 Luftballons	Nena				
1,000,000	Nine Inch Nails				
Love Buzz	Nirvana				
One & Only	Oliver Tree				
How Bizarre	OMC				
B.O.B. (RB Remix)	Outkast				
Good Time	Owl City & Carly Rae Jepsen				
Rose;Colored Boy	Paramore				
Scarlet	Periphery				
Fences	Phoenix				
Another Brick Pt 2	Pink Floyd				
Tommy the Cat (ft. Tom Waits)	Primus				
Let's Go Crazy	Prince and the Revolution				
A Kind Of Magic	Queen				
Higher Ground	Red Hot Chili Peppers				
New Noise	Refused				
Paper Wings	Rise Against				
Time Stand Still (ft. Aimee Mann)	Rush				
Scatman (Ski;Ba;Bop;Ba;Dop;Bop)	Scatman John				
Fine Again	Seether				
Whenever, Wherever	Shakira				
Selling Jesus	Skunk Anansie				
People = Shit	Slipknot				
De Música Ligera	Soda Stereo				
Let Me Drown	Soundgarden				
Circle With Me	Spiritbox				
Suspect Device	Stiff Little Fingers				
We Will Fall Together	Streetlight Manifesto				
Institutionalized	Suicidal Tendencies				
Devil Gate Drive	Suzi Quatro				
We Are Never Ever Getting Back Together (Taylor's Version)	Taylor Swift				
My Famed Disappearing Act	Thank You Scientist				
Video Killed the Radio Star	The Buggles				
How to Save a Life	The Fray				
Original Prankster (ft. Redman)	The Offspring				
Fox on the Run (Single Version)	The Sweet				
See Me, Feel Me (Live at Woodstock)	The Who				
Canajoharie	They Might Be Giants				
Steamy Windows	Tina Turner				
Acid Fuzz	Toxic Holocaust				
Hey, Soul Sister	Train				
Jump	Van Halen				
A Thousand Miles	Vanessa Carlton				
Rolling Girl (ft. Hatsune Miku)	wowaka				
Oh Bondage, Up Yours!	X;ray Spex				
Lights and Sounds	Yellowcard				
Silvertounge	Young the Giant				